Wog, Wo, Wo, Ww, Wwt, Ww^Wkf, Ds, Ds, Gs^Fp, Gg, Gg, Gg, Gs^Fp, Gg, Gg, Gg, Gg, Gg, Gg, Gg, Gs^Ft, Ss, Ss, Ss, Ss, Ss, Ss, Ss, Ss, Ss, Ss, Ss
Wog, Wog, Wo, Ww, Wwt, Wwrg^Wkf, Ds, Ds, Gs^Fp, Gg, Gg, Gg, Gs^Fp, Gg, Gg^Vht, Gg, Gg, Gg, Gg, Gg, Gs^Ft, Ss, Ss, Ss, Ss, Ss, Ss, Ss, Ss, Ss, Ss, Ss
Wo, Wo, Ww, Ww^Wkf, Wwrg^Wkf, Wwt, Wwf^Wkf, Ds, Ds, Gs^Fp, Gg, Gg, Re, Re, Gs^Ft, Gs^Ft, Re, Re, Gs^Ft, Gs^Ft, Re, Ss, Ss, Ss, Ss, Ss, Ss, Ss, Ss, Ss, Ss, Ss
Wo, Wo, Wwg^Wkf, Wwrg^Wkf, Wwrg^Es, Ww, Wwf^Wkf, Wwrg^Wkf, Ds, Gs^Fp, Gg, Gs^Ft, Gs^Ft, Ss, Ss, Re, Re, Gs^Ft, Re, Gs^Ft, Gs^Ft, Gs^Ft, Gs^Ft, Re, Re, Ss, Ss, Ss, Ss, Ss, Ss, Ss
Ww, Ww, Ww, Ww, Ww, Wwt, Ds, Ds, Gg, Gg, Gs^Ft, Re, Ss, Ss, Ss, Ss^Bw|, Ss, Re, Ss, Ss, Ss, Re, Re, Gs, Gs^Vht, Re, Ss, Ss, Ss, Ss, Ss, Ss
Wog, Wo, Wo, Wog, Ww, Ww^Wkf, Ds, Gg, Re, Re, Ss, Ss, Ss, Ss, Ss, Ss^Bw|, Ss, Ss, Ss, Ss, Ss, Ss, Re, Gs, Re, Re, Ss, Ss, Ss, Ss, Ss, Ss
Wo, Wo, Ww, Wo, Ww, Wwrg^Wkf, Wwrg^Wkf, Gg, Re, Ss, Ss, Ss, Re, Ss, Ss, Ss^Bw|, Ss, Ss, Ss, Ss^Vhs, Ss, Ss, Ss, Re, Ss, Ss, Ss^Em, Ss, Ss^Vhs, Ss, Ss^Em, Ss
Ww, Wwrg^Wkf, Ds, Wo, Wo, Ww, Wwrg, Rb, Gg^Ft, Ss, Re, Re, Gg, Re, Re, Rd, Cer, Ss, Ss, Ss, Ss, Ss, Ss, Ss^Bw|, Ss, Ss^Em, Ss, Ss, Ss, Ss, Ss, Ss
Ww, Ds, Gg^Ft, Ds, Ww^Wkf, Wo, Ww, Rb, Gg^Ft, Re, Gg^Ft, Co, 2 Ko, Co, Co^Vo, Rd^Bw/, Re^Ecf, Cer, Rb^Bw\, Ss, Ss, Ss, Ss, Ss^Bw|, Ss, Ss, Ss, Ss^Em, Ss, Ss, Ss, Ss
Ww, Wwf, Ss^Ftr, Gg^Ft, Ds, Wo, Wo^Bw/r, Ww^Bw/, Ww^Wkf, Rb, Gg^Vo, Ko, Co, Cer^Bw\, Rd, Rd, Rd^Vo, Rd, Re^Bw/r, Ko, Rb, Rb, Rb, Re, Rb, Ss, Re, Ss, Ss, Ss, Ss^Em, Ss
Ww, Wwrg^Wkf, Wwf, Ss^Ftr, Ss, Ww^Bw/, Wog, Wo, Wwrg^Es, Rb, Rb, Rb, Gg^Ft, Co, Rd, Re^Vo, Cer, Cer, Ss, Rb, Wwf^Wkf, Ss, Ss, Ss, Wwf^Wkf, Rb, Gs^Vht, Gs^Ft, Re, Ss, Ss, Ss
Ww^Wkf, Ww, Ds, Ss, Ds, Ww^Wkf, Wog, Wo, Wo, Wwrg, Ww^Wkf, Wwrg^Es, Ww^Wkf, Wwf^Esd, Ww^Bw|, Rb, Ww, Wwf^Wkf, Wwg, Wwg, Wog, Ww, Wwg, Ww^Es, Ww, Rb, Gs^Ft, Gs^Ft, Ss, Ss^Em, Ss, Ss
Ww^Wkf, Wwrg^Wkf, Ww, Ds, Wwf, Wwrg, Wwt, Wog, Wo, Wog, Wog, Wog, Wo, Wog, Wo^Bw|, Ww^Bw|r, Wog, Wog, Wog, Wog, Wwg, Wog, Wog, Wog, Wo^Bw/, Ww^Bw/, Wwg^Es, Wwg^Wkf, Ww, Wwg^Wkf, Ww, Ww
Wwg, Ww, Ww, Wwrg^Vhs, Wwf, Wwrg^Es, Wwt^Es, Wog, Wog, Wo, Wog, Wo, Wog, Wog, Ww^Bw|r, Wo^Bw|, Wwg, Wwg, Wwg^Wkf, Ww, Wwg^Wkf, Ww^Es, Ww^Bw/, Ww^Bw/, Wwg, Wog, Wog, Wog, Wog, Wwg, Wog, Wo
Wog, Ww^Wkf, Wo, Wwrg^Es, Wwrg, Wwf, Ds, Ww^Wkf, Ww^Wkf, Ww, Ww^Wkf, Ww, Ww^Ewsh, Ww, Rb, Wwg^Bw|, Rb, Ss^Em, Ss, Ss, Rb, Rb, Gg^Ft, Wwg^Wkf, Wwg^Wkf, Ww, Ww^Wkf, Wwg, Ww, Wog, Ww^Wkf, Ww
Wo, Wo, Ww, Wo, Ww^Wkf, Ds, Re^Esd, Gs^Ft, Gs^Ft, Wwrg^Wkf, Rb^Esd, Ds, Gg^Ft, Gg^Ft, Gg^Ft, Gg, Ss, Ss, Ss^Vhs, Ss^Ftr, Ss^Ftr, Re, Ss, Ss, Ss^Em, Ss, Wwf^Vhs, Wwf^Es, Wwf^Wkf, Wwg^Wkf, Ss^Ftr, Ss^Ftr
Ww, Ww, Ss^Ftr, Ww, Wwrg^Wkf, Gs^Ft, Ss, Ss^Vhs, Ss, Re^Esd, Ss^Ftr, Gg^Ft, Gg^Vht, Gg^Ft, Gg^Ftr, Re, Gg, Ww^Bw/r, Ss^Ftr, Ss, Ss, Ss, Re, Ss, Ss, Ss, Ss, Rb^Gvs, Ss, Ss^Emf, Ss^Ft, Ss^Ftr
Ww, Ww^Wkf, Ss^Qhhf, Ww^Wkf, Gs^Ft, Rb^Esd, Ss^Ftr, Ss, Ss, Ss, Re, Ss, Ss^Ftr, Gg^Ft, Re, Ss, Re, Gg, Re, Ss, Ss, Ss^Ftr, Gg^Gvs, Gg^Ft, Gg^Gvs, Ss^Ftr, Ss, Ss, Ss^Ftr, Ss^Ftr, Re^Es, Re
Ww, Ww^Wkf, Ww, Ww^Wkf, Rb^Esd, Gs^Ft, Ss, Re, Ss, Ss, Ss^Bw|, Ss, Re, Ss^Em, Ss, Ss^Em, Ss, Ss, Ss^Ftr, Ss^Bw\, Re, Re, Gg^Ft, Gg^Vht, Gg, Ss^Ft, Ss, Re, Re^Em, Ss^Em, Re, Re
Ww, Ww, Ww^Wkf, Kte^Vht, Cte, Ww^Es, Ww^Wkf, Ss^Ftr, Ss, Re, Ss^Vhs, Ss, Ss^Ftr, Ss, Ss^Ftr, Re, Ss, Ss^Ftr, Ss^Ftr, Ss, Ss, Ss, Ss^Ewl, Gg, Ss, Ss^Bw\, Gs, Gg^Ftr, Gg^Ft, Re, Ss, Ss
Ww, Ww, Wwrg^Wkf, Ww^Bw|r, Ww^Wkf, Cse, Ww^Wkf, Gs^Ft, Re, Ss, Re, Ss, Re, Ss^Ftr, Ss, Rb, Ss, Rb, Rb, Ss, Ss^Bw/, Ss^Vhs, Ss^Ewf, Ss^Ewl, Re, Gs^Ft, Md, Hh^Es, Gs^Gvs, Re, Ss, Ss
Ww, Ww^Wkf, Ds, Cte, Gg^Ft, Ww^Wkf, Wwf^Ewsh, Re, Ss, Ss, Ss, Ss^Ftr, Ss^Ftr, Re, Ss, Re, Ss, Ss^Ewf, Rb, Rb, Ss, Ss, Ss^Ewl, Ss^Ewl, Re, Gs^Fp, Hh^Gvs, Hh^Vht, Gs^Fp, Ss^Ftr, Re, Ss
Ww, Ww^Wkf, Wwt, Ds, Gg^Ft, Ss, Ss, Ss, Re^Ftr, Re, Ss, Rb, Rb, Ss, Rb, Ss^Ftr, Rb, Ss, Wwf^Wkf, Rb, Wwf^Wkf, Wwf^Wkf, Wwf, Re, Gg, Re, Gs^Ft, Gs^Edp, Re, Re, Ss, Ss
Wwg, Ww, Ww, Ww^Wkf, Ds, Ss, Rd^Esd, Rb^Ftr, Rd, Ss, Ss, Re, Rb, Ss, Ss, Re, Ww^Ewl, Ss, Ss, Wwf^Vhs, Wwf^Wkf, Wwrg^Wkf, Ss^Esa, Ss^Edb, Ss^Edb, Gg, Re, Re, Re, Ss^Efm, Ss^Ftr, Ss^Ftr
Wwg, Wwrg^Wkf, Ww, Ww^Wkf, Wwf^Ewsh, Ds, Dd^Vht, Ds, Ds^Esd, Rd, Ss, Rb, Ss^Bw\, Ss^Vhs, Ss^Ewf, Ww^Ewl, Ss^Es, Ss, Ss^Es, Ww^Ewl, Ss^Ewf, Ss^Esa, Ss, Ss^Dc, Wwf^Efm, Ss, Re, Gg, Gg, Ss^Ftr, Ss^Ftr, Ss^Ftr
Wwg, Ww^Wkf, Ww, Wwg, Ds^Ewsh, Ds, Ds, Wwrg^Wkf, Rd, Ss, Ss, Ss^Ewl, Rb, Rb, Ss^Ft, Ss, Rb, Ss, Ss^Edpp, Ss^Edb, Ss, Ss^Es, Ss, Wwf^Dc, Ww^Ewl, Ss, Ss, Re^Efm, Ss, Ss^Es, Ss^Ftr, Ss^Ftr
Ww, Ww^Wkf, Wwt, Wwrg^Wkf, Ds, Gg, Gs^Edb, Gs^Esd, Gs, Rd, Ss, Ss^Ftr, Rb, Ss^Ftr, Re, Ss^Ftr, Ss, Ss, Ss^Gvs, Ss^Eff, Ss^Gvs, Ss, Ss, Ss^Esd, Ss^Dc, Wwf^Ewl, Ss, Ss, Ss^Esd, Ss^Efm, Ss, Ss^Ftr
Ww, Ww, Ww^Wkf, Wwg, Wwf^Ewsh, Gg^Esd, Gg^Esd, Gs, Ss^Ftr, Rd, Ss^Ft, Rb, Ss, Ss, Ss, Ss^Eff, Ss, Ss, Wwf^Em, Ss^Wm, Cse^Vhs, Ss^Ewf, Ss^Es, Ss, Ss^Ewf, Ss^Es, Ss^Ewf, Ss, Wwf^Wkf, Ss, Ss, Ss
Wwg, Ww^Wkf, Ww, Wwt, Wwrt^Wkf, Wwf^Esa, Ds, Gs, Gs, Ss^Ftr, Gg, Rb, Rb, Ss, Ss^Gvs, Ss^Gvs, Re, Wwf^Edb, Cer^Vhs, 1 Kte^Vht, Cer^Edb, Cse^Vhs, Ss^Gvs, Ss^Edp, Ss^Ewf, Ss^Edb, Ss, Ss^Em, Wwf^Vhs, Wwrg^Qhhf, Ss^Em, Ss
Wwg, Ww, Wwrg^Wkf, Ww, Wwt, Wwg^Vhs, Wwrg^Wkf, Ds^Ewsh, Ds, Gg^Esd, Rb, Gg, Rb, Ss^Ftr, Re, Rb, Wwf^Wkf, Rb, Rb^Efs, Sm^Bw/r, Sm^Emf, Sm^Efs, Ss^Gvs, Ss, Ss^Esa, Ss^Efm, Ss, Wwrg^Wkf, Ss^Edp, Wwg^Ewf, Ss^Ftr, Ss
Wwg, Wwrg^Wkf, Wwg^Wkf, Ww, Ww, Wwrt, Ww^Wkf, Wwf^Ewsh, Ss, Ss, Ss^Ftr, Rb, Ss, Rb, Rb, Ss^Gvs, Ss, Ss^Gvs, Ss^Eff, Sm^Em, Ss, Ss^Gvs, Ss^Edp, Ss, Ss^Ftr, Ss^Em, Ss^Ewf, Ss, Ss, Ss, Ss^Ftr, Ss^Ftr
Wwg, Wwg, Wwg, Ww^Wkf, Ww, Ww, Ww, Ww^Wkf, Ss, Ss^Ftr, Ss^Ftr, Ss^Ftr, Ss, Ss, Re, Ss, Ss, Ss, Ss, Ss, Ss, Ss^Ewl, Ss^Ewl, Ww^Ewf, Ss^Ftr, Ss^Ftr, Ss^Ewl, Ss^Ewf, Ss^Ftr, Ss^Ftr, Ss^Ftr, Ss^Ftr
