Ss, Ss, Ss, Ss, Ss, Ss, Ss, Ss, Gll^Ftr, Gll^Ftr, Ss, Gll^Ftr, Gll^Ftr, Gll^Ftr, Re, Md, Hh^Qhh, Md, Md, Ss^Ft, Ss^Ft, Ss^Ft, Ss^Ft, Ss^Ft, Ss^Ft, Ss^Ft, Ss^Ft, Ss, Ss^Ft, Ss, Ss^Ft, Ss
Ss, Ss^Emf, Ss, Ss, Ss^Ft, Ss, Ss, Gll^Ftr, Gll^Ftr, Gll^Ftr, Ss, Gll^Ftr, Gll^Ftr, Gll^Ftr, Re, Md, Hh^Qhh, Md, Md, Ss^Ft, Ss^Ft, Ss^Ft, Ss^Ft, Ss^Ft, Ss, Ss^Ft, Ss, Ss^Ft, Ss, Ss^Ft, Ss, Ss^Ft
Re, Ss^Vhs, Ss, Ss, Ss^Ft, Ss, Ss, Gll^Ftr, Cse, Cse, 1 Kse, Re, Re^Dr, Re, Re, Gll^Ftr, Hh^Vd, Hh^Qhh, Ss^Qhu, Mm, Mm, Ss^Ft, Ss^Ft, Ss, Ss, Ss, Ss, Ss, Ss, Ss, Ss, Ss^Ft
Ss^Bw|, Ss, Ss, Ss, Ss, Ss, Ss, Ss, Ss, Cse, Cse, Re, Hh^Qhh, Gll^Ftr, Gll^Ftr, Re, Ss^Bw\r, Gll^Ftr, Re^Dr, Md, Ss, Md, Hh^Qhh, Ss, Ss, Ss, Ss, Ss, Ss, Ss, Ss, Ss
Re^Qhh, Ss, Re^Qhh, Ss, Ss, Ss, Ss, Ss, Ss, Ss, Ss, Ss, Hh^Qhh, Hh^Qhh, Hh^Qhh, Hh^Qhh, Hh^Qhh, Re, Hh^Qhh, Re^Qhh, Ss, Ss, Hh^Qhh, Hh^Qhh, Ss, Ss, Ss, Ss, Ss, Ss, Ss, Ss
Re^Qhh, Re^Qhh, Ss, Re^Qhh, Ss, Ss, Ss, Ss^Ft, Ss^Ft, Ss, Ss, Ss, Ss, Ss, Ss, Ss, Ss, Hh^Qhh, Ss, Ss, Ss, Ss, Ss, Hh^Qhh, Hh^Qhh, Ss, Ss, Ss, Ss, Ss, Ss, Ss
Re, Ss^Ft, Ss, Ss, Ss, Ss, Ss^Emf, Ss, Ss, Ss, Ss, Ss, Ss, Ss^Emf, Ss, Ss, Ss, Ss^Emf, Ss^Vhs, Ss, Ss, Ss, Ss, Hh^Qhh, Ss, Ss, Ss, Ss, Ss, Ss, Ss, Ss
Re, Gs^Qhh, Gs^Qhh, Ss, Gs^Qhh, Gs^Qhh, Gs^Qhh, Ss^Vhs, Re^Qhh, Ss, Re^Qhh, Ss, Ss, Ss^Vhs, Ss, Ss, Ss, Ss, Ss, Ss, Ss, Ss, Ss, Ss, Ss, Ss, Ss^Ft, Ss^Ft, Ss^Ft, Ss, Ss^Ft, Ss
Gs^Qhh, Re^Qhh, Re^Qhh, Ss, Re^Qhh, Re^Qhh, Ss^Bw\, Ss, Ss^Bw/, Re^Qhh, Re^Qhh, Re^Qhh, Gg, Gs, Gs, Re, Re, Re, Re, Ss, Re, Ss, Re, Ss, Ss, Ss, Ss, Ss^Ft, Ss^Ft, Ss^Ft, Ss^Ft, Ss^Ft
Gs^Qhh, Gs^Qhh, Gs^Qhh, Re^Qhh, Re^Qhh, Re^Qhh, Ss, Re^Qhh, Ss, Ss, Re^Qhh, Gs^Ft, Gs^Ft, Gs^Ft, Gs^Ft, Gs, Gs, Gs, Gs, Gs, Gs, Gs^Ft, Gs^Ft, Re, Re, Re, Ss, Ss, Ss, Ss^Ft, Ss^Ft, Ss^Ft
Gg^Qhh, Gs^Qhh, Re^Qhh, Re^Qhh, Ss, Ss, Re^Qhh, Ss, Ss, Re^Qhh, Gg, Gs^Ft, Gg, Gg, Gs, Gs, Hh, Hh^Qhh, Hh^Qhh, Gs, Gs, Gs^Ft, Gs^Ft, Gs^Ft, Gs^Ft, Gs^Ft, Re, Ss, Ss, Ss, Ss, Ss
Gs, Gs, Re^Qhh, Ss^Bw\, Ss^Bw\, Ss, Re^Qhh, Re^Qhh, Ss^Bw\, Re^Qhh, Gs, Hh, Hh, Hh^Qhh, Hh^Qhh, Hh, Hh, Gs, Gs, Gs, Gs^Ft, Gs^Ft, Gs^Ft, Re, Re, Gs^Ft, Ss^Vhs, Ss, Ss, Ss, Ss, Ss
Wwt, Gs^Vht, Ww, Ss, Ww^Wkf, Ss^Bw\, Ds^Qhh, Ss, Gg, Re^Qhh, Gg, Gs, Gg, Gs, Gg, Gs^Ft, Gg, Gs^Ft, Gg, Gs^Ft, Ss, Gs^Ft, Ss, Re, Ss, Ss, Ss, Ss, Ss, Ss, Ss, Ss
Wog, Wo, Ww, Wwt, Wwrg^Wkf, Ds, Ds, Gs^Ft, Gg, Gg, Gg, Gs^Ft, Gg, Gg, Gg, Gg, Gg, Gg, Gg, Gs^Ft, Ss, Ss, Ss, Ss, Ss, Ss, Ss, Ss, Ss, Ss, Ss, Re
Wo, Wo, Ww^Wkf, Wwt, Wwt, Ds, Ds, Gs^Ft, Gs^Ft, Gg, Gg, Gs^Ft, Re, Gg^Dr, Gs^Ft, Gg, Re, Gg, Gs^Ft, Gs^Ft, Ss, Ss, Ss, Ss, Ss, Ss, Ss, Ss, Ss, Ss, Ss, Ss
Wo, Ww, Wwrg^Wkf, Wwrg^Wkf, Ww, Wwf^Wkf, Wwrg^Wkf, Ds, Gs^Ft, Gg, Gs^Ft, Re, Ss, Gs^Ft, Re, Re, Gs^Ft, Gs^Ft, Gs^Ft, Re, Gs^Ft, Ss, Re, Ss, Ss, Ss, Ss, Ss, Ss, Ss, Ss, Ss
Ww, Wwg^Wkf, Ww, Wwrg^Es, Wwt, Wwf^Wkf, Ds, Ds, Gg, Gg, Re, Gs^Ft, Ss, Ss, Ss^Bw|, Re, Re, Re, Ss, Gs^Ft, Re, Gs^Ft, Gs, Re, Re, Ss, Ss, Ss, Ss, Ss, Ss, Ss
Wo, Ww, Wog, Ww, Ww^Wkf, Ds, Gg, Gg, Re, Gs^Ft, Ss, Ss, Ss, Ss, Ss^Bw|, Ss, Ss, Ss, Ss, Ss, Ss, Re, Gs, Gs^Dr, Re, Ss, Ss, Ss, Ss, Ss, Ss, Ss
Wo, Wo, Wo, Ww, Wwrg^Wkf, Ds, Gg, Re, Ss, Ss, Sm^Qhu, Sm^Qhu, Sm^Qhu, Ss, Ss^Bw|, Ss, Ss, Ss, Ss^Vhs, Ss, Ss, Re, Re, Re, Ss, Ss, Ss, Ss, Ss, Ss, Ss, Ss
Wwrg^Wkf, Ww, Wo, Ww, Ww, Wwrg^Wkf, Rb, Re, Sm^Qhu, Sm^Qhu, Re, Re, Re, Sm^Qhu, Rd, Sm^Qhu, Sm^Qhu, Ss, Ss, Ss, Ss, Ss, Ss^Bw|, Ss, Ss^Em, Ss^Em, Ss, Ss^Vhs, Ss, Ss^Em, Ss, Ss
Ds, Ds, Ds, Wo, Wo, Wwrg, Rb, Gg^Ft, Re, Re, Co, Sm^Qhu, Co, Re, Rd^Bw/, Cer, Cer, Sm^Qhu, Sm^Qhu, Ss, Ss, Ss, Ss^Bw|, Ss, Ss, Ss, Ss^Em, Ss, Ss, Ss, Ss, Ss
Wwf, Gg^Ft, Gg^Ft, Ww^Wkf, Wo, Ww, Ww^Bw/, Gg^Ft, Rb, Sm^Qhu, Ko, 2 Ko, Cer^Bw\, Co^Vo, Rd, Re^Ecf, Rd, Rb^Bw\, Ko, Sm^Qhu, Rb, Ss, Re, Ss, Ss, Ss, Ss, Ss, Ss, Ss, Ss, Ss
Wwrg^Wkf, Ss^Ftr, Ss^Ftr, Ds, Ww^Bw/, Wo^Bw/r, Wo, Ww^Wkf, Rb, Gg^Vo, Rb, Co, Co, Rd, Re^Vo, Rd^Vo, Cer, Re^Bw/r, Rb, Rb, Gg, Rb, Gg, Rb, Rb, Re, Gs^Ft, Ss, Ss, Ss^Em, Ss, Gg
Ww, Wwf, Ss, Ss, Ww^Wkf, Wog, Wo, Wwrg^Es, Wwrg, Rb, Wwrg^Es, Wwf, Wwf^Esd, Rd, Rb, Cer, Wwf^Wkf, Wwf, Wwg, Wwf^Wkf, Ww, Ss, Ww^Es, Wwf^Wkf, Rb, Gs^Dr, Gs^Ft, Re, Ss^Em, Ss, Ss, Gg
Wwrg^Wkf, Ds, Ds, Ds, Wwrg, Wog, Wog, Wo, Wog, Ww^Wkf, Wog, Ww^Wkf, Wog, Ww^Bw|, Ww^Bw|r, Ww, Wog, Wwg, Wog, Wog, Wog, Wwg, Wog, Ww, Ww^Bw/, Gs^Ft, Wwg^Wkf, Ss, Wwg^Wkf, Ss, Ww, Gg
Ww, Ww, Wwrg^Vhs, Wwf, Wwrg^Es, Wwt, Wog, Wo, Wo, Wog, Wo, Wo, Wog, Wo^Bw|, Wo^Bw|, Wog, Wwg, Wog, Ww, Wwg, Ww^Es, Wog, Ww^Bw/, Wo^Bw/, Wog, Wwg^Es, Wog, Ww, Wwg, Ww, Wo, Gg
Ww^Wkf, Ww, Wwrg^Es, Wwf, Wwf, Wwt^Es, Ww^Wkf, Wog, Ww, Wog, Ww, Wog, Ww, Ww^Bw|r, Wwg^Bw|, Wwg, Ss^Em, Wwg^Wkf, Ss, Wwg^Wkf, Rb, Ww^Bw/, Wwg^Wkf, Wwg, Ww, Wog, Wwg, Wog, Wog, Wog, Ww, Gg
Wo, Wo, Wo, Wwrg, Ds, Ds, Gs^Ft, Ww^Wkf, Wwrg^Wkf, Ww^Wkf, Ds, Ww^Ewsh, Gg^Ft, Rb, Gg, Rb, Ss, Ss, Ss^Ftr, Rb, Re, Ur^Fdw, Ss, Wwg^Wkf, Ss, Ww^Wkf, Wwf^Es, Ww, Wwg^Wkf, Ww^Wkf, Ss^Ftr, Gg
Ww, Ww, Ww, Ww^Wkf, Gs^Ft, Re^Esd, Ss^Vhs, Gs^Ft, Re^Esd, Rb^Esd, Gg^Ft, Gg^Ft, Gg^Ft, Gg^Ft, Re, Ss, Ww^Bw/r, Ss^Vhs, Ss, Ss^Ftr, Ss, Ss, Ss, Ss^Em, Ss, Wwf^Vhs, Rb^Gvs, Wwf^Wkf, Ss^Emf, Ss^Ftr, Ss^Ftr, Gg
Ww^Wkf, Ss^Ftr, Ww^Wkf, Wwrg^Wkf, Rb^Esd, Ss, Ss, Ss, Ss, Ss^Ftr, Ss, Gg^Dr, Gg^Ft, Gg^Ftr, Ss, Gg, Gg, Ss^Ftr, Ss, Ss, Ss^Ftr, Re, Gg^Ft, Ss, Ss^Ftr, Ss, Ss, Ss, Ss^Ftr, Ss^Ft, Re, Gg
Ww^Wkf, Ss^Qhhf, Ww^Wkf, Gs^Ft, Gs^Ft, Ss^Ftr, Re, Ss, Ss, Re, Ss, Ss^Ftr, Ss^Em, Re, Ss^Em, Re, Ss, Re, Ss^Bw\, Ss, Re, Gg^Gvs, Gg^Dr, Gg^Gvs, Ss^Ft, Ss, Re, Ss^Ftr, Ss^Em, Re^Es, Re, Gg
Ww, Ww, Ur^Dr, Rb^Esd, Ww^Es, Ss, Ss^Ftr, Gg, Re, Ss^Bw|, Ss, Re, Ss, Ss, Re, Ss, Ss^Ftr, Ss^Ftr, Ss, Re, Ss, Ur^Fdw, Ur, Ur^Edb, Ss^Bw\, Ss, Gg^Ftr, Re^Em, Re, Re, Ss, Gg
Ww, Ww^Wkf, Ww, Ur^Edb, Ss, Ww^Wkf, Gs^Ft, Ss, Ss, Ss^Vhs, Ss, Ur^Fdw, Ur^Fdw, Ur^Fdw, Rb, Ss, Rb, Ss^Ftr, Ss, Ss, Ss^Vhs, Ss^Ewl, Ss^Ewl, Ss, Gs^Ft, Gs, Hh^Es, Gg^Ft, Re, Ss, Ss, Gg
Ww^Wkf, Wwrg^Wkf, Ur, Ww^Wkf, Ww^Wkf, Ww^Wkf, Re, Re, Ss, Re, Ss^Ftr, Re, Re^Ecf, Ss, Re, Ss, Ss^Ewf, Rb, Rb, Ss^Bw/, Ss, Ss^Ewf, Ss^Ewl, Re, Sm^Qhu, Md, Hh^Dr, Gs^Gvs, Ss^Ftr, Ss, Ss, Gg
Ww^Wkf, Ds, Ds, Gg^Ft, Ss, Wwf^Ewsh, Ss, Ss, Re, Ss, Cer, Ss^Ftr, Ss, Ss, Ss^Ftr, Ss, Ss, Rb^Ecf, Rb, Ss, Wwf^Wkf, Ss^Ewl, Re, Re, Co, 3 Ko, Co, Sm^Qhu, Re, Re, Ss, Gg
Ww, Wwt, Ww^Wkf, Gg^Ft, Ss, Ss, Rb^Ftr, Re^Ftr, Ss, Ss, 4 Kerg, Cer, Ss, Rb, Re, Rb, Ss, Wwf^Wkf, Wwf^Vhs, Wwf^Wkf, Wwrg^Wkf, Wwf, Ss^Edb, Sm^Qhu, Sm^Qhu, Gs^Vo, Re^Bw|, Re, Ss^Efm, Ss, Ss^Ftr, Gg
Wwrg^Wkf, Ww, Ww^Wkf, Ds, Ds, Rd^Esd, Ds, Rd, Rd, Ss, Cer, Cer, Ss^Vhs, Ss, Ww^Ewl, Ww^Ewl, Ss, Ss, Ww^Ewl, Wwf^Wkf, Ss^Esa, Ss^Esa, Ss^Dc, Ss^Edb, Ss, Re, Co, Re, Sm^Qhu, Ss^Ftr, Gg, Gg
Ww^Wkf, Ww, Wwg, Wwf^Ewsh, Ds, Dd^Dr, Wwrg^Wkf, Ds^Esd, Ss, Ss, Ss^Ewl, Ss^Bw\, Rb, Ss^Ewf, Ss, Ss^Es, Ss, Ss^Es, Ss^Edb, Ss^Ewf, Ss^Es, Ss, Wwf^Dc, Wwf^Efm, Ss, Sm^Qhu, Sm^Qhu, Co, Sm^Qhu, Ss^Ftr, Ss^Ftr, Gg
Ww^Wkf, Ww, Wwrg^Wkf, Ds^Ewsh, Gg, Ds, Gs^Esd, Rd, Rd, Ss, Ss^Ftr, Rb, Ss^Ftr, Ss^Ft, Ss^Ftr, Rb, Ss, Ss^Edpp, Ss^Eff, Ss, Ss, Ss, Ss^Esd, Ww^Ewl, Wwf^Ewl, Ss, Ss, Sm^Qhu, Ss^Efm, Ss^Ftr, Ss^Ftr, Gg
Ww, Wwt, Wwg, Ds, Gg^Esd, Gs^Edb, Gs, Gs, Rd, Ss, Rb, Rb, Ss, Re, Ss^Eff, Ss, Ss, Ss^Gvs, Ss^Wm, Ss^Gvs, Ss^Ewf, Ss, Ss, Ss^Dc, Ss^Es, Ss, Ss, Ss^Esd, Ss, Ss, Ss, Gg
Ww^Wkf, Ww^Wkf, Wwt, Wwf^Ewsh, Wwf^Esa, Gg^Esd, Gs, Ss^Ftr, Ss^Ftr, Ss^Ft, Rb, Ss, Ss, Ss, Ss^Gvs, Ss, Wwf^Edb, Wwf^Em, Kte^Vht, Cse^Dr, Cse^Vhs, Ss^Es, Ss^Edp, Ss^Ewf, Ss^Edb, Ss^Ewf, Ss^Em, Wwf^Wkf, Wwrg^Qhhf, Ss, Ss, Gg
Ww, Ww, Ww, Wwrt^Wkf, Wwg^Vhs, Ds, Ds^Ewsh, Gs, Gg^Esd, Gg, Gg, Rb, Ss^Ftr, Ss^Gvs, Rb, Re, Rb, Cer^Dr, Sm^Bw/r, Cer^Edb, Sm^Efs, Ss^Gvs, Ss, Ss^Ewf, Ss^Efm, Ss, Wwrg^Wkf, Wwf^Vhs, Wwg^Ewf, Ss^Em, Ss, Gg
Sm, Wwrg^Wkf, Ww, Wwt, Wwrt, Wwrg^Wkf, Wwf^Ewsh, Ds, Sm, Rb, Rb, Rb, Rb, Re, Ss^Gvs, Wwf^Wkf, Ss^Gvs, Rb^Efs, Sm, Sm^Emf, Sm, Ss^Gvs, Sm, Ss^Esa, Sm, Ss, Sm, Ss^Edp, Sm, Ss^Ftr, Sm, Sm
