Cme, Cme, Cme, Cme, Cme, Cme, Cme, Wo, Wo, Wo, Cme, Cme, Cme, Wo, Wo, Wo, Cme, Cme, Cme, Cme, Cme, Cme
Cme, Cme, Cme, Cme, Cme, Cme, Gs, Wo, Wo, Wo, Cme, 2 Kme, Cme, Wo, Wo, Gg, Wo, Cme, Cme, Cme, Cme, Cme
Cme, Cme, Wo, Cme, Ww, Wo, Ww, Ww, Ww, Ww, Ww, Cme, Dd, Wo, Dd, Gg, Dd, Gg, Wo, Cme, Cme, Cme
Wo, Wo, Wo, Ww, Ww, Gs, Ww, Ww, Ww, Ww, Ww, Ww, Dd, Ss, Dd, Ss, Dd, Ww, Ww, Ww, Wwr, Ww
Wo, Wo, Wo, Ww, Ww, Gs, Ww, Ww, Ww, Ww, Ww, Ww, Dd, Ss, Dd, Ss, Dd, Ww, Ww, Ww, Wwr, Wo
Wo, Wo, Wo, Ww, Gs, Gs, Gs^Edp, Gs, Dd, Ww, Ww, Ww, Ss, Ss, Dd, Ss, Dd, Ww, Ww, Ww, Wwr, Wo
Wo, Wo, Ww, Ww, Gs^Do, Gs^Ftd, Gs^Ftd, Gs^Ftd, Dd, Dd, Ss, Ss, Dd, Dd, Dd, Dd, Ww, Ww, Wwr, Ww, Wwr, Wo
Wo, Wo, Ww, Ww, Gs, Gs^Ftp, Gd^Ftd, Gd^Ftd, Dd, Ss, Ww, Ss, Ww, Ww, Dd, Dd, Ww, Wwr, Wwr, Wo, Wo, Wo
Wo, Wo, Ww, Gs^Ftd, Gd^Ftd, Gs^Ftd, Gd^Ftd, Dd^Do, Dd, Dd, Ss, Ss, Ww, Ss, Ww, Ww, Wwr, Ww, Wo, Wo, Wo, Wo
Wo, Wo, Ww, Gd^Ftd, Gs^Do, Gd^Ftd, Gd^Ftd, Gd^Ftd, Dd, Dd, Dd, Dd, Dd, Ss, Dd, Ww, Wo, Wo, Wo, Wo, Wo, Wo
Wo, Wo, Ww, Ww, Cer, Gd^Ftd, Gd, Ss, Rd, Rd, Dd, Ss, Dd, Dd, Gs, Ww, Wo, Wo, Wo, Wo, Wo, Wo
Wo, Wo, Wo, Cer, Cer, Gd, Gd^Ftd, Rd, Ss, Gd^Ftd, Gd, Dd, Dd^Do, Gs, Gs, Ww, Ww, Ww, Wo, Wo, Wo, Wo
Wo, Wo, Ww, 1 Ko, Cer, Cer, Gd^Ftd, Gs^Ftd, Ss, Ss, Gs^Ftd, Gs, Gs, Gs^Edp, Gd^Fts, Gs, Ww, Ww, Wo, Wo, Wo, Wo
Wo, Wo, Ww, Gd^Ftd, Gd, Gd^Ftd, Gd^Ftd, Gd, Gs^Ftd, Gs, Gd, Gd, Gd, Gd^Fts, Gd^Fts, Ww, Ww, Wo, Wo, Wo, Wo, Wo
Wo, Wo, Ww, Dd^Do, Dd, Gd, Gd, Gs, Gs, Gs, Gs, Gs, Gd^Fts, Gd^Fts, Ww, Ww, Wo, Wo, Wo, Wo, Wo, Wo
Wo, Wo, Ww, Dd, Gs, Gd, Gs, Gs, Ss, Gs, Gs, Gs^Do, Gs, Ww, Ww, Wo, Wo, Wo, Wo, Wo, Wo, Wo
Wo, Wo, Ww, Dd, Gs, Gs, Gs, Ss, Gs, Gs, Gs^Edp, Gs, Gs, Ww, Ww, Wo, Wo, Wo, Wo, Wo, Wo, Wo
Wo, Wo, Ww, Ww, Wwr, Wwr, Gs, Gs, Gs, Gs, Gs, Gs, Wwr, Ww, Wo, Wo, Wo, Wo, Wo, Wo, Wo, Wo
Wo, Wo, Wo, Ww, Ww, Wwr, Gs, Gs^Do, Gs, Gs, Gs, Gs, Wwr, Ww, Wo, Wwr, Wwr, Wo, Wo, Wo, Wo, Wo
Wo, Wo, Wo, Wo, Ww, Wwr, Wwr, Gs, Ww, Gs, Wwr, Wwr, Wwr, Ww, Wwr, Wwr, Wo, Wo, Wo, Wo, Wo, Wo
Wo, Wo, Wo, Wo, Wo, Ww, Ww, Ww, Ww, Ww, Ww, Wwr, Ww, Wwr, Wwr, Wwr, Wo, Wo, Wo, Wo, Wo, Wo
Wo, Wo, Wo, Wo, Wo, Wo, Wo, Ww, Wo, Ww, Wo, Wo, Wo, Wwr, Wo, Wo, Wo, Wo, Wo, Wo, Wo, Wo
