Gs^Fts, Gs^Fts, Gs^Fts, Re, Re, Re, Gg, Ss^Fts, Gs^Fts, Ss, Gs^Fts, Gd^Fts, Gs^Fts, Ss, Gs^Fts, Ss, Gs^Fts, Ss, Gs^Fts, Ss, Ss, Ss, Ss, Ss, Ss, Ss, Ss, Ss, Gll^Ftr, Gll^Ftr, Ss, Gll^Ftr, Gll^Ftr, Gll^Ftr, Re, Md, Hh^Qhh, Md, Md, Ss^Ft, Ss^Ft, Ss^Ft, Ss^Ft, Ss^Ft, Ss^Ft, Ss^Ft, Ss^Ft, Ss, Ss^Ft, Ss, Ss^Ft
Gs^Fts, Gs^Fts, Gs^Fts, Gg, Sm^Qhu, Re, Re, Gs^Fts, Gg, Gs^Fts, Re, Re, Re, Gs^Fts, Re, Gs^Fts, Gs^Fts, Gs^Fts, Gs^Fts, Gs^Fts, Ss, Ss^Emf, Ss, Ss, Ss^Ft, Ss, Ss, Gll^Ftr, Gll^Ftr, Gll^Ftr, Ss, Gll^Ftr, Gll^Ftr, Gll^Ftr, Ce, Md, Hh^Qhh, Md, Md, Ss^Ft, Ss^Ft, Ss^Ft, Ss^Ft, Ss^Ft, Ss, Ss^Ft, Ss, Ss^Ft, Ss, Ss^Ft, Ss
Mm, Mm, Mm, Sm^Qhu, Co^Vo, Sm^Qhu, Gg, Re, Re, Re, Ss^Vhs, Ss, Ss, Re, Ss, Re, Re, Re, Re, Re, Re, Ss^Vhs, Ss, Ss, Ss^Ft, Ss, Ss, Gll^Ftr, Cse, Cse, Kse, Re, Ce^Dr, Ce, 6 Ke, Gll^Ftr, Hh^Vd, Hh^Qhh, Ss^Qhu, Mm, Mm, Ss^Ft, Ss^Ft, Ss, Ss, Ss, Ss, Ss, Ss, Ss, Ss
Mm, Md, 3 Ko, Co, Co, Sm^Qhu, Sm^Qhu, Gg, Gg, Re, Wwf^Bw\, Ss, Re, Ss, Ss, Ss, Ss, Ss, Ss, Ss, Ss^Bw|, Ss, Ss, Ss, Ss, Ss, Ss, Ss, Ss, Cse, Cse, Re, Hh^Qhh, Gll^Ftr, Gll^Ftr, Ce, Ss^Bw\r, Gll^Ftr, Re^Dr, Md, Ss, Md, Hh^Qhh, Ss, Ss, Ss, Ss, Ss, Ss, Ss, Ss
Hh, Hh, Co, Co, Sm^Qhu, Co^Vo, Sm^Qhu, Wwf, Wwf, Wwf, Gg^Efm, Re, Gg, Re, Re, Ss, Gg, Ss, Ss^Ft, Ss, Re^Qhh, Ss, Re^Qhh, Ss, Ss, Ss, Ss, Ss, Ss, Ss, Ss, Ss, Hh^Qhh, Hh^Qhh, Hh^Qhh, Hh^Qhh, Hh^Qhh, Re, Hh^Qhh, Re^Qhh, Ss, Ss, Hh^Qhh, Hh^Qhh, Ss, Ss, Ss, Ss, Ss, Ss, Ss
Hh, Hh, Co^Vo, Co, Co, Sm^Qhu, Gs^Fts, Gs^Fts, Gg, Gg^Efm, Gg^Fts, Gg^Fts, Gg^Fts, Gg, Gg, Ss^Bw\, Re, Gg, Gg, Ss^Ft, Re^Qhh, Re^Qhh, Ss, Re^Qhh, Ss, Ss, Ss, Ss^Ft, Ss^Ft, Ss, Ss, Ss, Ss, Ss, Ss, Ss, Ss, Hh^Qhh, Ss, Ss, Ss, Ss, Ss, Hh^Qhh, Hh^Qhh, Ss, Ss, Ss, Ss, Ss, Ss
Gs^Fts, Sm^Qhu, Sm^Qhu, Sm^Qhu, Sm^Qhu, Sm^Qhu, Gg^Vo, Gg, Gg, Gs^Qhhf, Gs^Qhhf, Gs^Qhhf, Gg^Fts, Gg, Ss^Vhs, Ss^Qhu, Gg, Re, Re, Re, Re, Ss^Ft, Ss, Ss, Ss, Ss, Ss^Emf, Ss, Ss, Ss, Ss, Ss, Ss, Ss^Emf, Ss, Ss, Ss, Ss^Bw|, Ss^Vhs, Ss, Ss, Ss, Ss, Hh^Qhh, Ss, Ss, Ss, Ss, Ss, Ss, Ss
Gg^Fts, Gg^Fts, Gs^Fts, Gg^Fts, Gs^Fts, Gg, Gg, Gg, Gg, Gg, Gs^Qhhf, Gs^Qhhf, Gg^Fts, Gs^Emf, Ss^Qhu, Ss^Qhu, Gg, Gs^Fts, Gg, Re, Re, Gs^Qhh, Gs^Qhh, Ss, Gs^Qhh, Gs^Qhh, Gs^Qhh, Ss^Vhs, Re^Qhh, Ss, Re^Qhh, Ss, Ss, Ss^Vhs, Ss, Ss, Ss, Ss^Bw|, Ss, Ss, Ss, Ss, Ss, Ss, Ss, Ss, Ss^Ft, Ss^Ft, Ss^Ft, Ss, Ss^Ft
Gg^Fts, Gg^Fts, Gg^Fts, Gg^Fts, Gg^Fts, Gg, Gg^Efm, Gg^Efm, Gg, Gg, Gg, Gs^Qhhf, Gg^Efm, Gg, Gg, Re, Gg, Gg, Re, Re, Gs^Qhh, Re^Qhh, Re^Qhh, Ss, Re^Qhh, Re^Qhh, Ss^Bw\, Ss, Ss^Bw/, Re^Qhh, Re^Qhh, Re^Qhh, Gg, Gs, Gs, Re, Re, Re, Re, Ss, Re, Ss, Re, Ss, Ss, Ss, Ss, Ss^Ft, Ss^Ft, Ss^Ft, Ss^Ft
Gg^Fts, Gg^Fts, Gg^Fts, Gg^Fts, Gg, Gg, Gg, Gg, Hh, Ss^Qhu, Ss^Qhu, Gg, Gg^Efm, Gg^Efm, 5 Ke, Gg, Gs^Fts, Gg^Efm, Gs^Vht, Gs, Gs^Qhh, Gs^Qhh, Gs^Qhh, Re^Qhh, Re^Qhh, Re^Qhh, Ss, Re^Qhh, Ss, Ss, Re^Qhh, Gs^Ft, Gs^Ft, Gs^Ft, Gs^Ft, Gs, Gs, Gs, Gs, Gs, Gs, Gs^Ft, Gs^Ft, Re, Re, Re, Ss, Ss, Ss, Ss^Ft, Ss^Ft
Gg^Fts, Gg^Fts, Hh^Fts, Gs^Fts, Hh^Fts, Gg, Gg, Gg, Hh, Hhd, Ss^Qhu, Gg, Gg, Hhd, Ce, Ce, Gg, Gg, Gg, Gs^Ft, Gg^Qhh, Gs^Qhh, Re^Qhh, Re^Qhh, Ss, Ss, Re^Qhh, Ss, Ss, Re^Qhh, Gg, Gs^Ft, Gg, Gg, Gs, Gs, Hh, Hh^Qhh, Hh^Qhh, Gs, Gs, Gs^Ft, Gs^Ft, Gs^Ft, Gs^Ft, Gs^Ft, Re, Ss, Ss, Ss, Ss
Hhd^Fts, Hhd^Fts, Hh^Fts, Hh^Fts, Gs^Fts, Gg, Gg^Vo, Gg^Eff, Gg^Eff, Hh, Gg, Gg, Gg, Gg^Vo, Gg, Gg, Gg, Gg, Re, Gg, Gs, Gs, Re^Qhh, Ss^Bw\, Ss^Bw\, Ss, Re^Qhh, Re^Qhh, Ss^Bw\, Re^Qhh, Gs, Hh, Hh, Hh^Qhh, Hh^Qhh, Hh, Hh, Gs, Gs, Gs, Gs^Ft, Gs^Ft, Gs^Ft, Re, Re, Gs^Ft, Ss^Vhs, Ss, Ss, Ss, Ss
Hhd^Fts, Hh^Fts, Hhd^Fts, Gs^Fts, Sm^Gvs, Sm^Gvs, Sm^Gvs, Sm^Gvs, Gg^Eff, Gg^Eff, Gg^Efm, Gg^Efm, Re, Re, Gg, Gs^Fts, Gg, Re, Wwrt, Ds^Ewsh, Wwt, Gs^Vht, Ww, Ss, Ww^Wkf, Ss^Bw\, Ds^Qhh, Ss, Gg, Re^Qhh, Gg, Gs, Gg, Gs, Gg, Gs^Ft, Gg, Gs^Ft, Gg, Gs^Ft, Ss, Gs^Ft, Ss, Re, Ss, Ss, Ss, Ss, Ss, Ss, Ss
Hhd^Fts, Hhd^Fts, Gg, Gs^Fts, Gs^Fts, Sm^Gvs, Gg^Eff, Gg^Eff, Re, Re, Re, Re, Wwrt, Re, Gg^Wm, Gs^Fts, Sm^Gvs, Re, Wwt^Wkf, Wwt^Wkf, Wog, Wo, Ww, Wwt, Wwrg^Wkf, Ds, Ds, Gs^Ft, Gg, Gg, Gg, Gs^Ft, Gg, Gg, Gg, Gg, Gg, Gg, Gg, Gs^Ft, Ss, Ss, Ss, Ss, Ss, Ss, Ss, Ss, Ss, Ss, Ss
Gg, Gg, Gg, Gg, Re, Re, Re, Re, Re, Re, Re, Re, Wwrt^Wkf, Wwrt^Wkf, Wwrt, Gs^Vht, Re, Re, Wwt, Wog^Ewl, Wo, Wo, Ww^Wkf, Wwt, Wwt, Ds, Ds, Gs^Ft, Gs^Ft, Gg, Gg, Gs^Ft, Re, Gg^Vht, Gs^Ft, Gg, Re, Gg, Gs^Ft, Gs^Ft, Ss, Ss, Ss, Ss, Ss, Ss, Ss, Ss, Ss, Ss, Ss
Re, Re, Re, Re, Re, Ds, Hd, Hd^Ewsh, Hd, Ds, Ds, Re, Re, Wwrt^Wkf, Wwrt, Re, Ds, Re, Ds^Ewsh, Wo, Wo, Ww, Wwrg^Wkf, Wwrg^Wkf, Ww, Wwf^Wkf, Wwrg^Wkf, Ds, Gs^Ft, Gg, Gs^Ft, Re, Ss, Gs^Ft, Re, Re, Gs^Ft, Gs^Ft, Gs^Ft, Re, Gs^Ft, Ss, Re, Ss, Ss, Ss, Ss, Ss, Ss, Ss, Ss
Re, Re, Re, Re, Ds, Ds^Ewsh, Ds, Ds, Ds, Ds^Wm, Wwrt, Ds^Ewsh, Wwt, Re^Esd, Wwt, Wwt^Ewf, Wwt^Wkf, Wwrt^Wkf, Wo, Wo, Ww, Wwg^Wkf, Ww, Wwrg^Es, Wwt, Wwf^Wkf, Ds, Ds, Gg, Gg, Re, Gs^Ft, Ss, Ss, Ss^Bw|, Re, Re, Re, Ss, Gs^Ft, Re, Gs^Ft, Gs, Re, Re, Ss, Ss, Ss, Ss, Ss, Ss
Wwt, Wwt, Wwt, Ds, Wwrt^Wkf, Wwrt^Wkf, Wwt, Wwrt, Ds, Ww^Vhs, Wwt, Wwt, Wo, Wwt^Ewf, Wo, Wo, Wo, Wo^Wkf, Wo, Ww, Wo, Ww, Wog, Ww, Ww^Wkf, Ds, Gg, Gg, Re, Gs^Ft, Ss, Ss, Ss, Ss, Ss^Bw|, Ss, Ss, Ss, Ss, Ss, Ss, Re, Gs, Gs^Vht, Re, Ss, Ss, Ss, Ss, Ss, Ss
Wwt, Wwt, Wwt, Wwt^Ewf, Wwt, Wwt, Wwt, Wwt^Ewl, Wwt, Wwt, Wwrg^Wkf, Ww, Wwt, Wo, Wo, Wo, Wo, Wo, Wo, Wog, Wo, Wo, Wo, Ww, Wwrg^Wkf, Ds, Gg, Re, Ss, Ss, Sm^Qhu, Sm^Qhu, Sm^Qhu, Ss, Ss^Bw|, Ss, Ss, Ss, Ss^Vhs, Ss, Ss, Re, Re, Re, Ss, Ss, Ss, Ss, Ss, Ss, Ss
Wo, Wo, Wot, Wot, Wot, Wo, Wot, Wwt, Ww, Ww, Ds, Ds, Ds, Wwt, Wo, Wo, Wo, Wo, Wo, Wo, Wwrg^Wkf, Ww, Wo, Ww, Ww, Wwrg^Wkf, Rb, Re, Sm^Qhu, Sm^Qhu, Re, Re, Re, Sm^Qhu, Rd, Sm^Qhu, Sm^Qhu, Ss, Ss, Ss, Ss, Ss, Ss^Bw|, Ss, Ss^Em, Ss^Em, Ss, Ss^Vhs, Ss, Ss^Em, Ss
Wo, Wot, Wwt^Ewl, Wwrt, Gd^Ftp, Ds, Ds^Em, Wwt, Wwrt, Ww, Wwf, Gg^Ft, Gg^Ft, Wwt, Wo, Wo, Wo, Wo, Wo, Ww, Ds, Ds, Ds, Wo, Wo, Wwrg, Rb, Gg^Ft, Re, Re, Co, Sm^Qhu, Co, Re, Rd^Bw/, Cer, Cer, Sm^Qhu, Sm^Qhu, Ss, Ss, Ss, Ss^Bw|, Ss, Ss, Ss, Ss^Em, Ss, Ss, Ss, Ss
Wo, Wot, Gd^Es, Rd, Rd^Esd, Ds^Em, Rd, Wwt^Ewf, Gd^Ftp, Wwf, Wwf, Gg^Ft, Wot, Ww, Ww, Wo, Wo, Wo, Wo, Ww, Wwf, Gg^Ft, Gg^Ft, Ww^Wkf, Wo, Ww, Ww^Bw/, Gg^Ft, Rb, Sm^Qhu, Ko, 1 Ko, Cer^Bw\, Co^Vht, Rd, Rd, Rd, Rb^Bw\, Ko, Sm^Qhu, Rb, Ss, Re, Ss, Ss, Ss, Ss, Ss, Ss, Ss, Ss
Wot, Wwt, Ds^Em, Gd^Vht, Ce, 4 Ke, Ce, Rd^Esd, Gs^Ftp, Gs^Ftp, Wot, Wot, Wwt, Wwt^Edb, Ds, Ww^Edb, Ww^Ewl, Wo, Wo, Wo, Wwrg^Wkf, Ss^Ftr, Ss^Ftr, Ds, Ww^Bw/, Wo^Bw/, Wo, Ww^Wkf, Rb, Gg^Vht, Rb, Co, Co, Rd, Re^Vht, Rd^Vht, Cer, Re^Bw/r, Rb, Rb, Gg, Rb, Gg, Rb, Rb, Re, Gs^Ft, Ss, Ss, Ss^Em, Ss
Wot, Wot, Ds^Esd, Rd^Em, Gd^Em, Ce, Gd^Es, Gd, Wwt, Gd^Em, Wwt^Bw\, Wot, Wwt, Gd^Fts, Rd, Ds^Em, Gd^Vht, Ds^Esd, Wo^Bw/, Wo^Bw/, Ww^Bw\, Wwf^Bw/, Ss, Ss, Ww^Wkf, Wog, Wo, Wwrg^Es, Wwrg, Rb, Wwrg^Es, Wwf, Wwf^Esd, Rd, Rb, Cer, Wwf^Wkf, Wwf, Wwg, Wwf^Wkf, Ww, Ss, Ww^Es, Wwf^Wkf, Rb, Gs^Vht, Gs^Ft, Re, Ss^Em, Ss, Ss
Wot, Ds, Wot, Gd^Ftp, Wwt^Ewl, Gs, Gs, Wot, Wot, Wwt, Ww^Wkf, Wwt^Bw\, Gs, Gd, Ss, Rd^Edp, Rd^Esd, Ds^Edp, Wo, Wo, Wwrg^Wkf, Ds, Ds, Ds, Wwrg, Wog, Wog, Wo, Wog, Ww^Wkf, Wog, Ww^Wkf, Wog, Ww^Bw|, Ww^Bw|, Ww, Wog, Wwg, Wog, Wog, Wog, Wwg, Wog, Ww, Ww^Bw/, Gs^Ft, Wwg^Wkf, Ss, Wwg^Wkf, Ss, Ww
Wo, Wot, Wot, Wot, Wwt, Gs^Em, Wot, Wot, Wot, Wwrt, Wwt, Wwt^Ewl, Gs^Fts, Ss, Ss, Gd^Ftp, Wwt^Ewl, Wwt, Wo, Wo, Ww, Ww, Wwrg^Vhs, Wwf, Wwrg^Es, Wwt, Wog, Wo, Wo, Wog, Wo, Wo, Wog, Wo^Bw|, Wo^Bw|, Wog, Wwg, Wog, Ww, Wwg, Ww^Es, Wog, Ww^Bw/, Wo^Bw/, Wog, Wwg^Es, Wog, Ww, Wwg, Ww, Wo
Wot, Wot, Wot, Wot, Wot, Wwt^Bw|, Wwt, Wot, Wwrt, Wwrt, Wwrt, Gd^Es, Rd, Ss, Ds^Em, Ds^Esd, Wwt, Wwrt, Wo, Wo, Ww^Wkf, Ww, Wwrg^Es, Wwf, Wwf, Wwt^Es, Ww^Wkf, Wog, Ww, Wog, Ww, Wog, Ww, Ww^Bw|, Wwg^Bw|, Wwg, Ss^Em, Wwg^Wkf, Ss, Wwg^Wkf, Rb, Ww^Bw/, Wwg^Wkf, Wwg, Ww, Wog, Wwg, Wog, Wog, Wog, Ww
Wot, Wwt, Wwt, Wot, Wwt, Wwt^Bw|, Rd^Esd, Wwt^Ewl, Gd^Es, Wwrt, Wwrt, Wwt, Wwrt, Gd^Es, Wwrt, Ds^Esd, Ww, Ww, Wo, Wo, Wo, Wo, Wo, Wwrg, Ds, Ds, Gs^Ft, Ww^Wkf, Wwrg^Wkf, Ww^Wkf, Ds, Ww^Ewsh, Gg^Ft, Rb, Gg, Rb, Ss, Ss, Ss^Ftr, Rb, Re, Ur^Fdw, Ss, Wwg^Wkf, Ss, Ww^Wkf, Wwf^Es, Ww, Wwg^Wkf, Ww^Wkf, Ss^Ftr
Wwt^Ewf, Wwt, Ds, Wwt, Wwrt, Gs^Em, Gd^Es, Ss, Ss^Emf, Rd^Esd, Wwrt, Wwt, Wwt^Ewl, Wwrt, Wwt, Ww, Ww, Ww, Wo, Wo, Ww, Ww, Ww, Ww^Wkf, Gs^Ft, Re^Esd, Ss^Vhs, Gs^Ft, Re^Esd, Rb^Esd, Gg^Ft, Gg^Ft, Gg^Ft, Gg^Ft, Re, Ss, Ww^Bw/, Ss^Vhs, Ss, Ss^Ftr, Ss, Ss, Ss, Ss^Em, Ss, Wwf^Vhs, Rb^Gvs, Wwf^Wkf, Ss^Emf, Ss^Ftr, Ss^Ftr
Wwt^Ewl, Wwt^Ewl, Ds^Esd, Wwt^Ewl, Wwr, Wwt, Ds^Em, Ss, Rd, Ds^Esd, Ww^Wkf, Ww^Wkf, Ds^Esd, Wwt, Wwt^Ewl, Ww, Ww, Ww, Wo, Wo, Ww^Wkf, Ss^Ftr, Ww^Wkf, Wwrg^Wkf, Rb^Esd, Ss, Ss, Ss, Ss, Ss^Ftr, Ss, Gg^Vht, Gg^Ft, Gg^Ftr, Ss, Gg, Gg, Ss^Ftr, Ss, Ss, Ss^Ftr, Re, Gg^Ft, Ss, Ss^Ftr, Ss, Ss, Ss, Ss^Ftr, Ss^Ft, Re
Ww, Gd^Es, Rd, Ds^Em, Wwr, Wwr, Ww, Ww, Wwt, Ds^Em, Ww, Ww, Wwt, Wwt, Ww, Ww, Ww, Ww, Wo, Ww, Ww^Wkf, Ss^Qhhf, Ww^Wkf, Gs^Ft, Gs^Ft, Ss^Ftr, Re, Ss, Ss, Re, Ss, Ss^Ftr, Ss^Em, Re, Ss^Em, Re, Ss, Re, Ss^Bw\, Ss, Re, Gg^Gvs, Gg^Vht, Gg^Gvs, Ss^Ft, Ss, Re, Ss^Ftr, Ss^Em, Re^Es, Re
Ww, Gd^Es, Rd^Edp, Ww^Ewl, Ww, Wwr, Ww, Wwg^Ewl, Wwrg, Wwrg, Ds^Em, Ww, Ww, Ww, Ww, Ww, Ww, Wo, Wo, Wo, Ww, Ww, Ur^Vht, Rb^Esd, Ww^Es, Ss, Ss^Ftr, Gg, Re, Ss^Bw|, Ss, Re, Ss, Ss, Re, Ss, Ss^Ftr, Ss^Ftr, Ss, Re, Ss, Ur^Fdw, Ur, Ur, Ss^Bw\, Ss, Gg^Ftr, Re^Em, Re, Re, Ss
Ww, Ww, Ww, Rd^Es, Ww, Wwg, Sm, Sm^Em, Ss, Wwrg, Wwrt, Wwt, Wwt, Ww, Ww, Ww, Wo, Wo, Wo, Ww, Ww, Ww^Wkf, Ww, Ur, Ss, Ww^Wkf, Gs^Ft, Ss, Ss, Ss^Vhs, Ss, Ur^Fdw, Ur^Fdw, Ur^Fdw, Rb, Ss, Rb, Ss^Ftr, Ss, Ss, Ss^Vhs, Ss^Ewl, Ss^Ewl, Ss, Gs^Ft, Gs, Hh^Es, Gg^Ft, Re, Ss, Ss
Wog, Ww, Ww, Gd, Ww^Ewl, Wwg^Ewl, Wwg, Gll^Vht, Wwt, Dd, Dd^Do, Wwrt, Wwt, Wwt, Wo, Wo, Wo, Wo, Wo, Wo, Ww^Wkf, Wwrg^Wkf, Ur, Ww^Wkf, Ww^Wkf, Ww^Wkf, Re, Re, Ss, Re, Ss^Ftr, Re, Re, Ss, Re, Ss, Ss^Ewf, Rb, Rb, Ss^Bw/, Ss, Ss^Ewf, Ss^Ewl, Re, Gs^Fp, Md, Hh^Vht, Gs^Gvs, Ss^Ftr, Ss, Ss
Wog, Wog, Wwr, Ds^Esd, Wwt^Vhs, Wwrt, Ds, Ds, Ds, Wwt, Gs^Ft, Dd, Wwt, Wwt, Wwt, Wo, Wo, Wo, Wo, Wo, Ww^Wkf, Ds, Ds, Gg^Ft, Ss, Wwf^Ewsh, Ss, Ss, Re, Ss, Rb, Ss^Ftr, Ss, Ss, Ss^Ftr, Ss, Ss, Rb, Rb, Ss, Wwf^Wkf, Ss^Ewl, Re, Re, Re, Hh^Gvs, Gs^Edp, Rb, Re, Re, Ss
Wo, Wo, Wwt, Wwt, Ds, Wwt, Ss^Emf, Gs^Ft, Gs^Ft, Wwt, Gs^Ft, Wwt, Ds, Wwrt, Wwrt, Wwt, Wo, Wo, Wo, Wo, Ww, Wwt, Ww^Wkf, Gg^Ft, Ss, Ss, Rb^Ftr, Re^Ftr, Ss, Ss, Re, Rb, Ss, Rb, Re, Rb, Ss, Wwf^Wkf, Wwf^Vhs, Wwf^Wkf, Wwrg^Wkf, Wwf, Ss^Edb, Gg, Gg, Re, Re, Re, Ss^Efm, Ss, Ss^Ftr
Wo, Wo, Wwt, Wwrt, Wwt, Wwt, Wwt, Gs^Ft, Wwt, Wwt, Wwt, Gs^Ft, Ds, Wwrt, Wwt, Wwt, Wo, Wo, Wo, Wo, Wwrg^Wkf, Ww, Cme^Vm, Ds, Ds, Rd^Esd, Ds, Rd, Rd, Ss, Rb, Rb, Ss^Vhs, Ss, Ww^Ewl, Ww^Ewl, Ss, Ss, Ww^Ewl, Wwf^Wkf, Ss^Esa, Ss^Esa, Ss^Dc, Ss^Edb, Ss, Re, Gg, Re, Ss^Ftr, Ss^Ftr, Ss^Ftr
Wo, Wo, Wo, Wwt, Dd, Dd, Gs^Ft, Wwt, Ss, Ss, Ds, Wwt, Wwt, Ds, Wwt, Wo, Wo, Wo, Wo, Wo, Ww^Wkf, Ww, Cme, 2 Kme, Ds, Dd^Vht, Wwrg^Wkf, Ds^Esd, Ss, Ss, Ss^Ewl, Ss^Bw\, Rb, Ss^Ewf, Ss, Ss^Es, Ss, Ss^Es, Ss^Edb, Ss^Ewf, Ss^Es, Ss, Wwf^Dc, Wwf^Efm, Ss, Re, Re^Efm, Gg, Ss^Es, Ss^Ftr, Ss^Ftr
Wo, Wo, Wo, Wwt, Wwrt, Dd, Dd, Gs^Ft, Dd, Gs^Ft, Gs^Ft, Ds, Wwt^Vhs, Wwt, Wwt, Wwt, Wwt, Wo, Wo, Wo, Ww^Wkf, Cme, Cme^Vm, Ds^Ewsh, Gg, Ds, Gs^Esd, Rd, Rd, Ss, Ss^Ftr, Rb, Ss^Ftr, Ss^Ft, Ss^Ftr, Rb, Ss, Ss^Edpp, Ss^Eff, Ss, Ss, Ss, Ss^Esd, Ww^Ewl, Wwf^Ewl, Ss, Ss, Re, Ss^Efm, Ss^Ftr, Ss^Ftr
Wo, Wo, Wo, Wwt, Wwt, Wwrt, Wwrt, Dd^Do, Wwrt, Ds, Wwt, Wwt, Wwt, Wwt, Wwt, Wwt, Wwt, Wo, Wo, Wo, Ww, Wwt, Wwg, Ds, Gg^Esd, Gs^Edb, Gs, Gs, Rd, Ss, Rb, Rb, Ss, Re, Ss^Eff, Ss, Ss, Ss^Gvs, Ss^Wm, Ss^Gvs, Ss^Ewf, Ss, Ss, Ss^Dc, Ss^Es, Ss, Ss, Ss^Esd, Ss, Ss, Ss
Wo, Wo, Wo, Wo, Wo, Wwt, Wwt, Wwrt, Wwt, Wwrt, Wwt, Wwt, Wo, Wwt, Wo, Wwt, Wo, Wo, Wo, Wo, Ww^Wkf, Ww^Wkf, Wwt, Wwf^Ewsh, Wwf^Esa, Gg^Esd, Gs, Ss^Ftr, Ss^Ftr, Ss^Ft, Rb, Ss, Ss, Ss, Ss^Gvs, Ss, Wwf^Edb, Wwf^Em, Kte^Vht, Cse, Cse^Vhs, Ss^Es, Ss^Edp, Ss^Ewf, Ss^Edb, Ss^Ewf, Ss^Em, Wwf^Wkf, Wwrg^Qhhf, Ss, Ss
Wo, Wo, Wo, Wo, Wo, Wo, Wo, Wo, Wo, Wwt, Wo, Wo, Wo, Wo, Wo, Wo, Wo, Wo, Wo, Wo, Ww, Ww, Ww, Wwrt^Wkf, Wwg^Vhs, Ds, Ds^Ewsh, Gs, Gg^Esd, Gg, Gg, Rb, Ss^Ftr, Ss^Gvs, Rb, Re, Rb, Cer, Sm^Bw/r, Cer^Edb, Sm, Ss^Gvs, Ss, Ss^Ewf, Ss^Efm, Ss, Wwrg^Wkf, Wwf^Vhs, Wwg^Ewf, Ss^Em, Ss
Wo, Wo, Wo, Wo, Wo, Wo, Wo, Wo, Wo, Wo, Wo, Wo, Wo, Wo, Wo, Wo, Wo, Wo, Wo, Wwg, Wwrg^Wkf, Wwrg^Wkf, Ww, Wwt, Wwrt, Wwrg^Wkf, Wwf^Ewsh, Ds, Ss, Rb, Rb, Rb, Rb, Re, Ss^Gvs, Wwf^Wkf, Ss^Gvs, Rb, Sm^Em, Sm^Emf, Ss^Gvs, Ss^Gvs, Ss, Ss^Esa, Ss^Em, Ss, Ss, Ss^Edp, Ss, Ss^Ftr, Ss^Ftr
Wo, Wo, Wo, Wo, Wo, Wo, Wo, Wo, Wo, Wo, Wo, Wo, Wo, Wo, Wo, Wo, Wo, Wo, Wo, Wwg, Wwg, Wwg^Wkf, Ww^Wkf, Ww, Ww, Ww^Wkf, Ww^Wkf, Ss, Ss^Ftr, Ss^Ftr, Ss^Ftr, Ss, Ss, Rb, Ss, Ss, Ss, Ss^Eff, Ss, Ss, Ss^Ewl, Ss^Edp, Ww^Ewf, Ss^Ftr, Ss^Ftr, Ss^Ewf, Ss^Ewf, Ss, Ss^Ftr, Ss^Ftr, Ss^Ftr
