Gs^Fp, Gs^Fp, Gs^Fp, Gs^Fp, Gs^Fp, Gs^Fp, Gs^Fp, Gs^Fp, Re, Re, Gs^Fp, Gs^Fp, Gs^Fp, Gs^Fp, Gs^Fp, Gs^Fp, Gs^Fp, Gs^Fp, Gs^Fp, Gs^Fp, Gs^Fp, Gs^Fp, Gs^Fp, Gs^Fp, Gs^Fp, Gs^Fp, Gg, Gs^Fp, Gg, Gs^Fp, Gs^Fp, Gs^Fp, Gg, Gs^Fp, Gg, Gg, Gg, Hh, Hh, Hh, Gg, Mm, Mm, Mm, Mm, Mm, Mm, Mm, Mm, Mm, Mm, Mm, Mm, Mm, Mm, Mm, Mm, Mm, Mm, Mm, Mm, Mm, Mm, Mm, Mm, Mm, Mm, Mm, Mm, Mm, Mm, Mm, Mm, Mm, Mm, Mm, Mm, Mm, Mm, Mm, Mm, Mm, Wwf, Mm, Mm, Mm, Mm, Mm, Mm, Mm, Mm, Mm, Mm, Gs^Fp, Mm, Mm, Mm, Mm, Mm, Mm, Mm, Mm
Gs^Fp, Gs^Fp, Gs^Fp, Gs^Fp, Gs^Fp, Gs^Fp, Gs^Fp, Gs^Fp, Re, Re, Gs^Fp, Gs^Fp, Gs^Fp, Gs^Fp, Gs^Fp, Gs^Fp, Gs^Fp, Gs^Fp, Gs^Fp, Gs^Fp, Gs^Fp, Gs^Fp, Gs^Fp, Gs^Fp, Gs^Fp, Gs^Fp, Gg, Gs^Fp, Gg, Gs^Fp, Gs^Fp, Gs^Fp, Gg, Gs^Fp, Gg, Gg, Gg, Hh, Hh, Hh, Gg, Mm, Mm, Mm, Mm, Mm, Mm, Mm, Mm, Mm, Mm, Mm, Mm, Mm, Mm, Mm, Mm, Mm, Mm, Mm, Mm, Mm, Mm, Mm, Mm, Mm, Mm, Mm, Mm, Mm, Mm, Mm, Mm, Mm, Mm, Mm, Mm, Mm, Mm, Mm, Mm, Mm, Wwf, Mm, Mm, Mm, Mm, Mm, Mm, Mm, Mm, Mm, Mm, Gs^Fp, Mm, Mm, Mm, Mm, Mm, Mm, Mm, Mm
Ds, Ds, Ds, Gs^Fp, Gs^Fp, Gs^Fp, Gs^Fp, Gs^Fp, Gs^Fp, Re, Re, Gs^Fp, Gs^Fp, Gs^Fp, Gs^Fp, Gs^Fp, Gs^Fp, Gs^Fp, Gs^Fp, Gs^Fp, Gs^Fp, Gs^Fp, Gs^Fp, Gs^Fp, Gs^Fp, Gg, Gs^Fp, Gs^Fp, Gg, Gg, Gs^Fp, Gg, Gg, Gg, Gg, Gg, Gg, Hh, Hh^Vhh, Hh, Hh, Mm, Mm, Mm, Mm, Mm, Ww, Wwf, Mm, Mm, Mm, Mm, Mm, Mm, Mm, Mm, Mm, Mm, Mm, Wwf, Ww, Mm, Mm, Mm, Mm, Mm, Mm, Wwf, Mm, Mm, Mm, Mm, Mm, Mm, Mm, Mm, Mm, Mm, Mm, Mm, Mm, Mm, Ww, Mm, Mm, Mm, Mm, Mm, Mm, Mm, Mm, Mm, Mm, Mm, Mm, Mm, Mm, Mm, Mm, Mm, Mm, Mm
Ds, Ds, Ds, Ds, Gs^Fp, Gs^Fp, Gs^Fp, Gs^Fp, Gs^Fp, Gs^Fp, Gs^Fp, Re, Re, Gs^Fp, Gs^Fp, 2 Gg^Ve, Gs^Fp, Gs^Fp, Gs^Fp, Gs^Fp, Gs^Fp, Gs^Fp, Gs^Fp, Gs^Fp, Gg^Ve, Gg, Gg, Gs^Fp, Gs^Fp, Gg, Gs^Fp, Gg, Gs^Fp, Gg, Gs^Fp, Gg, Hh, Hh, Hh, Gg, Hh, Mm, Mm, Mm, Mm, Mm, Ww, Hh, Mm, Mm, Mm, Mm, Gg, Mm, Gg, Mm, Mm, Mm, Mm, Mm, Ww, Hh, Mm, Mm, Mm, Mm, Mm, Wwf, Ww, Mm, Wo, Wo, Wo, Mm, Hh, Mm, Mm, Mm, Mm, Mm, Mm, Mm, Ww, Mm, Mm, Mm, Mm, Mm, Mm, Mm, Mm, Mm, Wwf, Mm, Mm, Mm, Mm, Mm, Mm, Mm, Mm, Mm
Ww, Ww, Ww, Ds, Ds, Gs^Fp, Gs^Fp, Gs^Fp, Gs^Fp, Gs^Fp, Gs^Fp, Gs^Fp, Gg, Gg, Hh, Gs^Fp, Gg, Gs^Fp, Gs^Fp, Gs^Fp, Gs^Fp, Gs^Fp, Gs^Fp, Gs^Fp, Gs^Fp, Gs^Fp, Gg, Gs^Fp, Gg, Gg, Gg, Gg, Gg, Gs^Fp, Gg, Gs^Fp, Gg, Gg, Hh, Hh, Gg, Hh, Gg, Gg, Hh, Hh, Ww, Ww, Hh, Hh, Gg, Gg, Gg, Gg, Gg, Gg, Gg, Gg, Gg, Hh, Wwf, Mm, Mm, Hh, Hh, Hh, Mm, Hh, Wo, Ww^Vm, Wo, Ww, Ww, Hh, Hh, Hh, Hh, Mm, Mm, Mm^Vhh, Mm, Mm, Ww, Mm, Mm, Mm, Mm, Mm, Mm^Vhh, Mm, Mm, Wwf, Mm, Mm, Mm, Mm, Mm, Mm, Mm, Mm, Mm, Mm
Ww, Ww, Ww, Ds, Ds, Ds, Ds, Gs^Fp, Gs^Fp, Gs, Gs^Fp, Gs^Fp, Gg, Hh, Hh, Gg, Gs^Fp, Gs^Fp, Gs^Fp, Gs^Fp, Gs^Fp, Gs^Fp, Gs^Fp, Gs, Gg, Gg, Gs^Fp, Gs^Fp, Gg, Gg, Gs^Fp, Gs^Fp, Gg, Gs^Fp, Gg, Gg, Gg, Hh, Gg, Gg, Hh, Hh, Gg, Gg, Gg, Hh, Wwf, Wwf, Hh, Gg, Hh, Gs^Fp, Gg, Gg, Gg, Gg, Gg, Gg, Gg, Hh, Wwf, Hh, Hh, Mm, Hh, Hh, Hh, Hh, Ww, Ww, Ww, Ww, Hh, Mm, Mm, Mm, Hh, Mm, Mm, Mm, Mm, Ww, Ww, Mm, Mm, Mm, Hh, Mm, Mm, Mm, Ww, Ww, Mm, Mm, Mm, Mm, Wwf, Mm, Mm, Mm, Mm, Mm
Wo, Wo, Wo, Ww, Ww, Ds, Ds, Gs^Fp, Gs^Fp, Gs^Fp, Gs^Fp, Re, Gs^Fp, Gs^Fp, Gg, Gs^Fp, Gs^Fp, Gs^Fp, Gs^Fp, Gs^Fp, Gs^Fp, Gs^Fp, Gs^Fp, Gs^Fp, Gs^Fp, Gs^Fp, Gs^Fp, Gs^Fp, Gg, Gs^Fp, Gg, Gg, Gg, Gg, Gs^Fp, Gg, Gg, Gs^Fp, Gg, Gg, Gg, Gg, Gg, Gg, Hh, Hh, Wwf, Wwf, Gg, Hh, Gg, Hh, Gg, Gs^Fp, Gg, Gg, Gs^Fp, Gg, Gg, Gg, Wo, Gg, Hh, Gg, Gg, Hh, Gg, Hh, Hh, Ww, Wwf, Wwf, Wwf, Gg, Mm, Hh, Hh, Hh, Mm, Mm, Hh, Ww, Ww, Mm, Mm, Hh, Hh, Hh, Mm, Mm, Ww, Mm, Mm, Mm, Ww, Wwf, Mm, Mm, Mm, Mm, Mm, Mm
Wo^Xo, Wo, Wo, Wo, Ww, Ww, Ds, Gs^Fp, Gs, Gs^Fp, Gs^Fp, Re, Gs^Fp, Gs^Fp, Gs^Fp, Gs^Fp, Gs^Fp, Gs^Fp, Gs^Fp, Gs^Fp, Gs^Fp, Gs^Fp, Gs^Fp, Gs^Fp, Gs^Fp, Gs^Fp, Gs, Gs^Fp, Gs^Fp, Gg, Gg, Gg, Gg, Gs^Fp, Gg, Gg, Gg, Gg, Gg, Gg, Gg, Gs^Fp, Gs^Fp, Hh, Hh, Hh, Ww, Ww, Gg, Gg, Gg, Hh, Gg, Gg, Gg, Gg, Gg, Gg, Gs^Fp, Gg, Gg, Wo, Gg, Hh, Hh, Gs^Fp, Hh, Gg, Hh, Wwf, Wwf, Wwf, Wo, Gs^Fp, Gg, Hh, Gg, Mm, Hh, Mm, Hh, Wwf, Wwf, Mm, Gg, Mm, Mm, Mm, Hh, Hh, Wwf, Mm, Ww, Ww, Mm, Mm, Hh, Mm, Mm, Mm, Wwf, Wwf
Wo^Xo, Wo^Xo, Wo^Xo, Wo, Wo, Wo, Gs^Fp, Gs^Fp, Gs^Fp, Gs^Fp, Gs^Fp, Re, Gs^Fp, Gs^Fp, Gs^Fp, Gs^Fp, Gs, Gs^Fp, Gs^Fp, Gs^Fp, Gs^Fp, Gs^Fp, Gs^Fp, Gs^Fp, Gs^Fp, Gs^Fp, Gs^Fp, Gg, Gs^Fp, Gg, Gg, Gg, Gs^Fp, Gs^Fp, Gg, Gs^Fp, Gs^Fp, Gg, Gs^Fp, Gs^Fp, Gg, Gg, Gs^Fp, Gs^Fp, Hh, Gs^Fp, Ww, Ww, Hh, Hh, Hh, Gg, Gg, Gg, Gg, Gs^Fp, Wo, Wo, Wo, Wo, Wo, Wo, Gg, Hh, Hh, Hh, Gs^Fp, Gg, Hh, Gs^Fp, Wo, Ww, Wo, Hh, Hh, Gs^Fp, Gg, Hh, Gs^Fp, Hh, Hh, Wwf, Wo, Hh, Hh, Hh, Hh, Hh, Gg, Hh, Wwf, Wwf, Hh, Mm, Ch, Chr, 3 Kh, Hh, Ww, Ww, Mm, Mm
Wo^Xo, Wo^Xo, Wo^Xo, Wo^Xo, Wo^Xo, Wo, Wo, Gs^Fp, Gs^Fp, Gg, Gs^Fp, Re, Gs^Fp, Gs^Fp, Gs^Fp, Gs^Fp, Gs^Fp, Gs^Fp, Gs^Fp, Gs^Fp, Gs^Fp, Gs^Fp, Gg, Gg, Gg, Gs^Fp, Gs^Fp, Gg, Gs^Fp, Gg, Gg, Gs^Fp, Gg, Gs^Fp, Gg, Gg, Gg, Gg, Gg, Gg, Gg, Gg, Gs^Fp, Gg, Hh, Gs^Fp, Ww, Ww, Gg, Gg, Hh, Gs^Fp, Gg, Gs^Fp, Gg, Gs^Fp, Wo, Gs^Fp, Gg, Gg, Gg, Gg, Hh, Gg, Hh, Gg, Gg, Gs^Fp, Hh, Gg, Gg, Wo, Wo, Gs^Fp, Gs^Fp, Hh, Gs^Fp, Gg, Gg, Hh, Gg, Wo, Gg, Gg, Hh, Hh, Gg, Hh, Gg, Wo, Gg, Hh, Hh, Hh, Gg, Gg, Chr, Chw, Ww, Ww, Mm, Mm
Wo, Wo^Xo, Wo^Xo, Wo^Xo, Wo^Xo, Wo^Xo, Wo, Wo, Wo, Gs^Fp, Re, Re, Gg, Gs^Fp, Gg, Gs^Fp, Gs^Fp, Gs^Fp, Gs^Fp, Gs^Fp, Gs^Fp, Gs^Fp, Gg, Gs^Fp, Gs^Fp, Gg, Gs^Fp, Gg, Gg, Gg, Gg, Gs^Fp, Gs^Fp, Gg, Gg, Gs^Fp, Gg, Gg, Gs^Fp, Gs^Fp, Gs^Fp, Gg, Gs^Fp, Gg, Gs^Fp, Hh, Ww, Ww, Hh, Hh, Gg, Gg, Gs^Fp, Gg, Gg, Gs^Fp, Wo, Gs^Fp, Gs^Fp, Gg, Gs^Fp, Gs^Fp, Gs^Fp, Gg, Gs^Fp, Hh, Hh, Hh, Gs^Fp, Gg, Wo, Wo, Wo, Gg, Gs^Fp, Hh, Gg, Gs^Fp, Gg, Gs^Fp, Hh, Wo, Gg, Gs^Fp, Hh, Gg, Hh, Gg, Wo, Wo, Hh, Gg, Hh, Hh, Gg, Hh, Ww, Ww, Mm, Mm, Mm, Mm
Wo, Wo, Wo, Wo^Xo, Wo^Xo, Wo^Xo, Wo^Xo, Wo, Wo, Wo, Ww^Bw|, Gs^Fp, Ww, Ww, Ww, Gs^Fp, Gs^Fp, Gs^Fp, Gs^Fp, Gs, Gs^Fp, Gs^Fp, Gg, Gg, Gs^Fp, Gs^Fp, Gs^Fp, Gs^Fp, Gs^Fp, Gg, Gg, Gs^Fp, Gs^Fp, Gs^Fp, Gs^Fp, Gs^Fp, Gs^Fp, Gs^Fp, Gg, Gs^Fp, Gg, Gs^Fp, Gg, Gg, Gg, Gs^Fp, Ww, Ww, Gg, Hh, Gg, Gg, Gs^Fp, Gg, Gg, Gs^Fp, Gs^Fp, Wo, Gs^Fp, Gg, Gg, Gg, Gs^Fp, Hh, Gs^Fp, Gg, Gg, Hh, Gg, Gg, Wo, Wo, Gs^Fp, Gs^Fp, Hh, Hh, Hh, Hh, Gs^Fp, Gg, Gg, Wo, Gg, Gg, Gg, Gs^Fp, Hh, Gs^Fp, Wo, Gg, Hh, Hh, Gg, Gg, Hh, Hh, Wwf, Mm, Mm, Mm, Mm, Mm
Wo, Wo, Wo, Wo, Wo, Wo^Xo, Wo, Wo^Xo, Wo, Wo, Ww^Bw|, Wo, Wo, Ww, Ww, Ww, Ww, Ww, Ww, Gs^Fp, Gs^Fp, Gs^Fp, Gs^Fp, Gg, Wo, Wo, Wo, Wo, Wo, Wo, Wo, Wo, Wo^Xo, Wo, Wo^Xo, Wo, Wo, Wo, Wo, Gg, Gs^Fp, Gg, Gs^Fp, Gs^Fp, Gs^Fp, Gs^Fp, Ww, Ww, Gs^Fp, Gs^Fp, Gs^Fp, Gg, Gs^Fp, Gg, Gs^Fp, Gs^Fp, Gs^Fp, Wo, Gs^Fp, Gs^Fp, Gs^Fp, Gg, Gs^Fp, Gs^Fp, Gs^Fp, Gs^Fp, Gs^Fp, Gg, Gs^Fp, Wo, Wo, Wo, Gs^Fp, Gs^Fp, Gs^Fp, Hh, Gs^Fp, Gs^Fp, Hh, Hh, Wo, Wo, Gg, Gs^Fp, Gs^Fp, Gg, Gg, Gs^Fp, Wo, Gs^Fp, Hh, Hh, Hh, Gs^Fp, Wo, Wwf, Hh, Hh, Mm, Mm, Mm, Mm
Ww, Ww, Ww, Wo, Wo, Wo, Wo, Wo, Wo, Wo, Ww^Bw|, Wo, Wo^Xo, Wo, Wo, Wo, Wo, Ww, Wo, Ww, Ww, Ww, Ww, Ww, Wo, Wo, Wo^Xo, Wo^Xo, Wo^Xo, Wo^Xo, Wo^Xo, Wo^Xo, Wo, Wo^Xo, Wo, Wo^Xo, Wo^Xo, Wo, Wo, Gs^Fp, Gs^Fp, Gs^Fp, Gs^Fp, Gs^Fp, Gs^Fp, Gs^Fp, Ww, Ww, Ww, Ww, Ww, Gs^Fp, Ww, Gs^Fp, Gg, Gs^Fp, Gg, Wo, Wo, Ww, Ww, Gs^Fp, Ww, Gs^Fp, Ww, Gs^Fp, Ww, Gs^Fp, Ww, Wo, Gg, Wo, Wo, Gs^Fp, Ww, Gs^Fp, Wo, Gg, Wo, Wo, Gs^Fp, Gs^Fp, Hh, Gs^Fp, Gg, Hh, Hh, Gs^Fp, Wo, Gs^Fp, Hh, Gg, Gg, Gs^Fp, Wo, Gg, Hh, Gg, Mm, Mm^Vhh, Mm, Mm
Gg, Gg, Ds, Ww, Wo, Wo, Gs^Fp, Wo, Wo, Wo, Ww^Bw|, Wo, Wo, Wo^Xo, Wo^Xo, Wo^Xo, Wo^Xo, Wo^Xo, Wo^Xo, Wo, Wo^Xo, Wo, Wo^Xo, Wo^Xo, Wo^Xo, Wo^Xo, Wo, Wo^Xo, Wo, Wo, Wo, Wo, Wo, Gs^Fp, Gs^Fp, Wo, Wo, Wo^Xo, Wo^Xo, Wo, Wo, Gs^Fp, Ww, Gs^Fp, Ww, Ww, Ww, Ww, Wo, Wo, Wo, Ww, Wo, Ww, Ww, Gg, Ww, Wo, Wo, Ww, Wo, Ww, Wo, Ww, Wo, Ww, Wo, Ww, Wo, Ww, Ww, Wo, Wo, Ww, Wo, Wo, Wo, Wo, Wo, Ww, Ww, Gs^Fp, Gs^Fp, Hh, Gs^Fp, Gs^Fp, Gs^Fp, Wo, Gs^Fp, Hh, Gs^Fp, Gs^Fp, Wo, Wo, Hh, Hh, Gg, Gg, Mm, Mm, Mm, Mm
Gg, Gg, Ds, Ww, Ww, Ww, Ww, Ww, Gs^Fp, Wo, Ww^Bw|, Wo, Wo, Wo^Xo, Wo^Xo, Wo^Xo, Wo, Wo, Wo, Wo^Xo, Wo, Wo^Xo, Wo, Wo, Wo, Wo, Gs^Fp, Gs^Fp, Gs^Fp, Gs^Fp, Gs^Fp, Wo, Gg, Gs^Fp, Gs^Fp, Wo, Wo, Wo, Wo, Wo^Xo, Wo^Xo, Wo, Wo, Ww, Wo, Wo, Wo, Wo, Wo, Wo, Wo^Xo, Wo, Wo, Wo, Wo, Ww^Bw|, Wo, Wo, Wo, Wo, Wo, Wo, Wo, Wo, Wo, Wo, Wo, Wo, Wo^Xo, Wo, Wo^Xo, Wo, Wo^Xo, Wo, Wo^Xo, Wo, Wo^Xo, Wo, Wo^Xo, Wo, Wo, Ww, Ww, Ww, Ww, Gs^Fp, Wo, Wo, Gs^Fp, Gs^Fp, Gs^Fp, Gs^Fp, Wo, Hh, Wo, Hh, Wwf, Hh, Ww, Wwf, Wwf, Wwf
Ds, Ds, Ww, Ww, Ds, Ww, Gs^Fp, Ww, Wo, Wo, Ww^Bw|, Wo, Wo, Wo^Xo, Wo^Xo, Wo^Xo, Wo, Gg, Gs^Fp, Wo, Gs^Fp, Wo, Gs^Fp, Gs^Fp, Gg, Gs^Fp, Gs^Fp, Gg, Gg, Gs^Fp, Gs^Fp, Gs^Fp, Gs^Fp, Gs^Fp, Re, Gg, Gs^Fp, Wo, Gs^Fp, Wo, Wo, Wo^Xo, Wo^Xo, Wo, Wo^Xo, Wo, Wo, Wo, Wo^Xo, Wo^Xo, Wo, Wo^Xo, Wo^Xo, Wo, Wo^Xo, Wo, Wo^Xo, Wo, Wo^Xo, Wo^Xo, Wo^Xo, Wo^Xo, Wo^Xo, Wo^Xo, Wo^Xo, Wo^Xo, Wo^Xo, Wo^Xo, Wo^Xo, Wo^Xo, Wo, Wo^Xo, Wo, Wo^Xo, Wo, Wo^Xo, Wo, Wo^Xo, Wo, Wo^Xo, Wo^Xo, Wo, Wo, Ww, Wo, Wo, Wo, Wo, Wo, Wo, Wo, Wo, Wo, Wo, Hh, Wo, Hh, Wwf, Hh, Mm, Mm, Mm
Ww, Ww, Gs^Fp, Ds, Gs^Fp, Ww, Ww, Gs^Fp, Gg, Gs^Fp, Gs^Fp, Wo, Wo, Wo^Xo, Wo^Xo, Wo^Xo, Wo^Xo, Wo, Wo, Gs^Fp, Wo, Gs^Fp, Gs^Fp, Gs^Fp, Gs^Fp, Gs^Fp, Gs^Fp, Gg, Ss, Gg, Ss, Gs^Fp, Re, Re, Gs^Fp, Re, Gg, Gs^Fp, Gs^Fp, Gs^Fp, Wo, Wo, Wo, Wo^Xo, Wo^Xo, Wo^Xo, Wo^Xo, Wo^Xo, Wo, Wo, Wo, Wo, Wo, Wo^Xo, Wo, Wo^Xo, Wo, Wo^Xo, Wo, Wo, Wo, Wo, Wo, Wo, Wo, Wo, Wo, Wo, Wo, Wo, Ww, Wo, Ww, Wo, Ww, Wo, Wo, Wo, Ww, Wo, Ww, Wo^Xo, Wo^Xo, Wo^Xo, Wo^Xo, Wo, Wo, Gs^Fp, Gs^Fp, Gs^Fp, Gs^Fp, Gg, Wo, Hh, Hh, Hh, Mm, Hh, Mm^Vhh, Mm, Mm, Mm
Gs^Fp, Gs^Fp, Ss^Vhs, Ss, Ss, Gs^Fp, Gs^Fp, Ww, Ww, Ww, Ww, Gs^Fp, Ww, Wo, Wo, Wo^Xo, Wo, Wo, Wo, Wo, Wo, Wo, Wo, Gs^Fp, Gg, Gg, Re, Re, Gs^Fp, Ss^Vhs, Ss, Re, Gs^Fp, Gs^Fp, Gs^Fp, Gg, Wo, Gg, Gg, Wo, Wo, Wo, Wo^Xo, Wo^Xo, Wo, Wo, Wo, Wo, Ww, Wo, Ww, Wo, Wo, Wo, Wo, Wo, Wo, Wo, Wo, Wo, Ww, Ww, Ww, Wo, Wo, Wo, Ww, Ww, Ww, Wo, Ww, Ww, Ww, Ww, Gs^Fp, Ww, Ww, Ww, Gs^Fp, Ww, Gs^Fp, Wo, Xu, Wo^Xo, Wo^Xo, Wo^Xo, Wo, Gs^Fp, Gs^Fp, Gg, Gg, Gg, Gg, Wwf, Wwf, Mm, Mm, Mm, Mm, Mm, Mm, Mm
Gs^Fp, Gs^Fp, Gs^Fp, Gs^Fp, Ss, Gg, Gs^Fp, Gs^Fp, Gs^Fp, Re, Gg, Ww, Gs^Fp, Gs^Fp, Gg, Wo, Wo, Wo, Wo, Wo, Wo, Wo, Wo, Wo, Wo, Gg, Re, Gg, Ww, Ss, Gg, Gs^Fp, Gs^Fp, Gg, Wo, Wo, Wo^Xo, Wo, Wo, Wo, Wo^Xo, Wo^Xo, Wo, Wo, Wo, Wo, Ww, Ww, Gs^Fp, Ww, Ww, Ww, Ww, Wo, Ww, Ww^Bw|, Ww, Ww, Ww, Ww, Ww, Ww, Ww, Ww, Ww, Ww, Gs^Fp, Ww, Gs^Fp, Ww, Gs^Fp, Gs^Fp, Gs^Fp, Gs^Fp, Re, Gg, Re, Gg, Xu, Xu, Xu, Xu, Xu, Xu, Xu, Wo^Xo, Wo^Xo, Wo, Wo, Gs^Fp, Gs^Fp, Hh, Hh, Gg, Hh, Ww, Ww, Mm, Mm, Mm, Mm, Mm
Gs^Fp, Gs^Fp, Ss, Gs^Fp, Re, Gs^Fp, Gs^Fp, Gs^Fp, Re, Re, Gs^Fp, Gs^Fp, Gs^Fp, Gs^Fp, Gs^Fp, Gg, Gg, Wo, Wo, Wo, Wo, Wo, Wo, Wo, Wo, Ww^Bw/, Wo, Gg, Wo, Gg, Wo, Wo^Xo, Wo, Wo, Wo^Xo, Wo^Xo, Wo^Xo, Wo^Xo, Wo^Xo, Wo^Xo, Wo^Xo, Wo^Xo, Gg, Ww, Ww, Ww, Gs^Fp, Gs^Fp, Gs^Fp, Gs^Fp, Gs^Fp, Gs^Fp, Gs^Fp, Ww, Gs^Fp, Re, Gs^Fp, Gs^Fp, Gg, Gg, Re, Gs^Fp, Gg, Gs^Fp, Gs^Fp, Gs^Fp, Gs^Fp, Gs^Fp, Gs^Fp, Gs^Fp, Gs^Fp, Gs^Fp, Re, Re, Gg, Re, Rr, Xu, Re, Xu, Rr, Re, Ww, Xu, Wo, Wo, Ww, Wo^Xo, Wo^Xo, Wo, Gs^Fp, Hh, Hh, Gg, Gg, Hh, Mm, Ww, Ww, Mm, Mm, Mm
Gs^Fp, Gs^Fp, Ss, Ss, Gs^Fp, Ss, Re, Re, Gs^Fp, Gs^Fp, Gs^Fp, Gs^Fp, Gs^Fp, Gs^Fp, Gs^Fp, Gs^Fp, Gs^Fp, Wo, Wo, Wo, Gs^Fp, Wo, Wo, Wo, Wo, Wo, Wo, Wo, Wo, Wo, Wo, Wo^Xo, Wo^Xo, Wo^Xo, Wo^Xo, Wo^Xo, Wo^Xo, Wo^Xo, Wo^Xo, Wo^Xo, Gg, Gg, Gg, Ww, Ww, Ww, Ww, Gs^Fp, Re, Re, Re, Re, Re, Gs^Fp, Re, Re, Re, Re, Gs^Fp, Gs^Fp, Gs^Fp, Re, Re, Re, Re, Re, Gs^Fp, Re, Re, Re, Gg, Re, Gs^Fp, Gg, Gg, Re, Xu, Rr, Rr, Re, Xu, Qxu, Uu, Wo, Xu, Xu, Xu, Wo, Wo^Xo, Wo, Gs^Fp, Hh, Hh, Hh, Gg, Hh, Mm, Mm, Mm, Wwf, Mm, Mm
Gs^Fp, Gs^Fp, Gs^Fp, Gs^Fp, Re, Re, Gs^Fp, Gs^Fp, Gs^Fp, Gs^Fp, Gg, Gs^Fp, Gs^Fp, Gs^Fp, Gs^Fp, Gs^Fp, Ww, Ww, Ww, Gg, Ss, Gs^Fp, Re, Wo, Wo, Wo, Wo, Wo, Wo, Wo, Wo, Wo^Xo, Wo^Xo, Wo^Xo, Wo^Xo, Wo^Xo, Wo^Xo, Wo^Xo, Gs^Fp, Gs^Fp, Gs^Fp, Gs^Fp, Gs^Fp, Gg, Gg, Ww, Gs^Fp, Gs^Fp, Re, Gs^Fp, Gs^Fp, Gs^Fp, Gs^Fp, Re, Gs^Fp, Re, Gs^Fp, Gs^Fp, Gs^Fp, Gs^Fp, Gs^Fp, Gs^Fp, Gs^Fp, Gs^Fp, Gs^Fp, Gg, Gg, Gs^Fp, Gs^Fp, Gs^Fp, Gs^Fp, Gs^Fp, Gs^Fp, Gg, Re, Re, Xu, Xu, Xu, Xu, Xu, Qxu, Qxu, Ww, Uu, Xu, Xu, Wo, Wo^Xo, Wo, Gg, Gs^Fp, Gg, Hh, Gg, Hh, Mm, Mm, Mm, Mm, Mm, Mm
Gs^Fp, Gs^Fp, Gs^Fp, Gs^Fp, Re, Gs^Fp, Gs^Fp, Gs^Fp, Gs^Fp, Gg, Gs^Fp, Gg, Gs^Fp, Gs^Fp, Gs^Fp, Gs^Fp, Gs^Fp, Gs^Fp, Gs^Fp, Ww, Gs^Fp, Re, Gs^Fp, Gg, Gs^Fp, Wo, Gs^Fp, Wo, Wo, Wo, Gs^Fp, Wo^Xo, Wo^Xo, Gs^Fp, Gs^Fp, Gs^Fp, Gs^Fp, Gs^Fp, Gs^Fp, Gs^Fp, Gs^Fp, Gs^Fp, Gs^Fp, Gg, Gs^Fp, Gg, Re, Re, Gs^Fp, Gs^Fp, Gs^Fp, Gs^Fp, Gs^Fp, Gg, Gg, Re, Gs^Fp, Gs^Fp, Gs^Fp, Gs^Fp, Gs^Fp, Gs^Fp, Gs^Fp, Gs^Fp, Gs^Fp, Gs^Fp, Gs^Fp, Gs^Fp, Gs^Fp, Gg, Gs^Fp, Gg^Vh, Re, Re, Xu, Xu, Xu, Xu, Qxu, Qxu, Qxu, Qxu, Rr, Ww, Ww, Xu, Wo, Wo, Wo^Xo, Wo, Hh, Gg, Hh, Gg, Gg, Hh^Vhh, Mm, Mm, Mm, Mm, Mm, Mm
Gs^Fp, Gs^Fp, Gs^Fp, Gs^Fp, Re, Gs^Fp, Gs^Fp, Gs^Fp, Gs^Fp, Gs^Fp, Gs^Fp, Gs^Fp, Gs^Fp, Gg, Gs^Fp, Gs^Fp, Gs^Fp, Gs^Fp, Gs^Fp, Gs^Fp, Ss^Vhs, Ss, Gs^Fp, Gg, Gs^Fp, Gs^Fp, Gs^Fp, Wo, Ww, Gs^Fp, Ss, Gs^Fp, Gs^Fp, Wo^Xo, Wo^Xo, Gs^Fp, Gs^Fp, Gs^Fp, Gs^Fp, Gs^Fp, Gs^Fp, Gs^Fp, Gg, Gg, Gg, Gs^Fp, Re, Gs^Fp, Gs^Fp, Gs^Fp, Gs^Fp, Gg^Ve, Gs^Fp, Gg, Gs^Fp, Re, Gs^Fp, Gs^Fp, Gs^Fp, Gs^Fp, Gs^Fp, Gs^Fp, Gs^Fp, Gs^Fp, Gs^Fp, Gs^Fp, Gs^Fp, Gg, Gs^Fp, Gs^Fp, Gs^Fp, Gs^Fp, Re, Re, Re, Xu, Qxu, Xu, Qxu, Qxu, Rr, Qxu, Qxu, Rr, Ww, Ww, Ww, Ww, Wo, Wo^Xo, Wo, Gg, Hh, Gg, Hh, Hh, Hh, Mm, Mm, Mm, Mm, Mm
Gs^Fp, Gs^Fp, Gs^Fp, Gs^Fp, Gs^Fp, Re, Gs^Fp, Gs^Fp, Gs^Fp, Gs^Fp, Gs^Fp, Gs^Fp, Gs^Fp, Gs^Fp, Gs^Fp, Gs^Fp, Gs^Fp, Gs^Fp, Gs^Fp, Gs^Fp, Gs^Fp, Ss, Re, Re, Gg, Gs^Fp, Gs^Fp, Gs^Fp, Ss, Ss, Ss, Ss, Gs^Fp, Gs^Fp, Wo^Xo, Gs^Fp, Gs^Fp, Gs^Fp, Gs^Fp, Gs^Fp, Gs^Fp, Gs^Fp, Gs^Fp, Gs^Fp, Gs^Fp, Gs^Fp, Re, Gs^Fp, Gs^Fp, Gs^Fp, Gs^Fp, Gs^Fp, Gs^Fp, Gs^Fp, Gs^Fp, Re, Gs^Fp, Gs^Fp, Gs^Fp, Gs^Fp, Gs^Fp, Gs^Fp, Gs^Fp, Gs^Fp, Gs^Fp, Gs^Fp, Gs^Fp, Gs^Fp, Gg, Gs^Fp, Gs^Fp, Gs^Fp, Re, Re, Xu, Xu, Qxu, Qxu, Rr, Rr, Qxu, Rr, Rr, Qxu, Qxu, Qxu, Qxu, Ww, Ww, Wo^Xo, Wo, Wo, Wo, Hh, Wwf, Wwf, Wwf, Hh, Ww, Mm, Mm, Mm
Gs^Fp, Gs^Fp, Gs^Fp, Gs^Fp, Gs^Fp, Re, Re, Gs^Fp, Gs^Fp, Gs^Fp, Gg, Gs^Fp, Gs^Fp, Gs^Fp, Gs^Fp, Gs^Fp, Gs^Fp, Gs^Fp, Gs, Gs^Fp, Re, Re, Gs^Fp, Gs^Fp, Gs^Fp, Gg, Gg, Gg, Ss, Ss, Ss, Ss, Gg, Gs^Fp, Gs^Fp, Wo^Xo, Wo^Xo, Gs^Fp, Ww, Gs^Fp, Gs^Fp, Gs^Fp, Gs^Fp, Gs^Fp, Gs^Fp, Gs^Fp, Re, Gs^Fp, Gs^Fp, Gs^Fp, Gs^Fp, Gs^Fp, Gs^Fp, Gs^Fp, Gs^Fp, Re, Re, Gs^Fp, Gs^Fp, Gs^Fp, Gs^Fp, Gs^Fp, Gs^Fp, Gs^Fp, Gs^Fp, Gs^Fp, Gs^Fp, Gs^Fp, Gs^Fp, Gg, Gs^Fp, Gg, Re, Xu, Xu, Xu, Xu, Qxu, Uu, Rr, Qxu, Qxu, Qxu, Rr, Ww, Xu, Xu, Re, Ww, Wo^Xo, Hh, Gg, Hh, Wo, Hh, Hh, Hh, Ww, Mm, Ww, Ww, Ww
Gs^Fp, Gs^Fp, Gs^Fp, Gs^Fp, Gs^Fp, Gs^Fp, Re, Re, Gs^Fp, Gg, Gs^Fp, Gs^Fp, Gs^Fp, Gg, Gs^Fp, Gs, Gs^Fp, Gs^Fp, Gs^Fp, Re, Gs^Fp, Gs^Fp, Gs^Fp, Gs^Fp, Gs^Fp, Gs^Fp, Gs^Fp, Gg, Gg, Ss, Gs^Fp, Gs^Fp, Gs^Fp, Gs^Fp, Gs^Fp, Gs^Fp, Ww, Wo^Xo, Wo^Xo, Ww, Ww, Gs^Fp, Gs^Fp, Gs^Fp, Gs^Fp, Gs^Fp, Re, Gs^Fp, Gg, Gs^Fp, Gs^Fp, Gs^Fp, Gs^Fp, Gs^Fp, Gs^Fp, Gs^Fp, Gs^Fp, Re, Re, Gs^Fp, Gs^Fp, Gs^Fp, Gs^Fp, Gs^Fp, Gs^Fp, Gg, Gs^Fp, Gs^Fp, Gs^Fp, Gs^Fp, Gs^Fp, Hh, Re, Xu, Xu, Xu, Xu, Qxu, Uu, Uu, Qxu, Qxu, Qxu, Uu, Ww, Rr, Xu, Re, Wo, Wo^Xo, Hh, Gg, Gg, Gg, Hh, Gg, Hh, Hh, Mm, Mm, Mm, Mm
Gs^Fp, Gs^Fp, Gs^Fp, Gs^Fp, Gs^Fp, Gs^Fp, Gs^Fp, Re, Re, Gg, Gs^Fp, Gs^Fp, Gs^Fp, Gg, Gs^Fp, Gs^Fp, Gs^Fp, Re, Gs^Fp, Gs^Fp, Gs^Fp, Gg, Gs^Fp, Gs^Fp, Gs^Fp, Gs^Fp, Gs^Fp, Gs^Fp, Gs^Fp, Gs^Fp, Gs^Fp, Gs^Fp, Gs^Fp, Gs^Fp, Gs^Fp, Gs^Fp, Gs^Fp, Wo, Wo^Xo, Wo, Ww, Gs^Fp, Gs^Fp, Gs^Fp, Gs^Fp, Gs^Fp, Re, Gs^Fp, Gs^Fp, Gs^Fp, Gg, Gs^Fp, Gs^Fp, Gs^Fp, Gs^Fp, Gs^Fp, Gs^Fp, Gs^Fp, Gs^Fp, Re, Gs^Fp, Gs^Fp, Gs^Fp, Gg, Gs^Fp, Gs^Fp, Gs^Fp, Gg, Gs^Fp, Gs^Fp, Gs^Fp, Gs^Fp, Hh, Hh, Xu, Xu, Xu, Qxu, Qxu, Rr, Cud, Qxu, Uu, Uu, Ww, Rr, Re, Re, Wo^Xo, Wo^Xo, Gg, Hh, Gg, Hh, Gg, Hh, Hh, Mm, Hh, Mm, Mm, Mm
Gs^Fp, Gs^Fp, Gs^Fp, Gs^Fp, Gs^Fp, Gs^Fp, Gs^Fp, Gs^Fp, Re, Gg, Gs^Fp, Gs^Fp, Gs^Fp, Gs, Re, Re, Gs^Fp, Gs^Fp, Gg, Gs^Fp, Gg, Gs^Fp, Gs^Fp, Gs^Fp, Gs, Gs^Fp, Gs^Fp, Gs^Fp, Gs^Fp, Gs^Fp, Gs^Fp, Gs^Fp, Gs^Fp, Gs^Fp, Gs^Fp, Gs^Fp, Wo^Xo, Wo^Xo, Ww, Ww, Gs^Fp, Gs^Fp, Gs^Fp, Gs^Fp, Re, Re, Gs^Fp, Gs^Fp, Gs^Fp, Gs^Fp, Gs^_s, Gs^_s, Gs^_s, Gg, Gs^Fp, Gs^Fp, Gs^Fp, Gs^Fp, Gs^Fp, Re, Re, Gs^Fp, Gs^Fp, Gs^Fp, Gs^Fp, Gs^Fp, Gs^Fp, Gs^Fp, Gs^Fp, Gs^Fp, Gs^Fp, Gg, Gg, Re, Xu, Xu, Xu, Qxu, Qxu, Cud, 4 Kud, Qxu, Qxu, Ww, Xu, Wo, Wo, Wo, Wo^Xo, Hh, Hh, Gg, Gg, Hh, Hh, Gg, Hh, Mm, Mm, Mm^Vhh, Mm, Mm
Gs^Fp, Gs^Fp, Gs^Fp, Gs^Fp, Gs^Fp, Gs^Fp, Gs^Fp, Gs^Fp, Gs^Fp, Re, Gs^Fp, Gs^Fp, Gs^Fp, Re, Gs^Fp, Gs^Fp, Gs^Fp, Gs^Fp, Gs^Fp, Gg, Gg, Gs^Fp, Gg^Ve, Gs^Fp, Gs^Fp, Gs^Fp, Gs^Fp, Gs^Fp, Gs^Fp, Gs^Fp, Gs^Fp, Gs^Fp, Gs^Fp, Gs^Fp, Wo^Xo, Gs^Fp, Wo^Xo, Gs^Fp, Gs^Fp, Gs^Fp, Gs^Fp, Gs^Fp, Re, Re, Gg, Gs^Fp, Gs^Fp, Gs^Fp, Gs^Fp, Gs^Fp, Gs^_s, Gs^_s, Gs^_s, Gs^Fp, Gg, Gs^Fp, Gs^Fp, Gs^Fp, Gs^Fp, Gs^Fp, Re, Gs^Fp, Gs^Fp, Gs^Fp, Gs^Fp, Gs^Fp, Gs^Fp, Gs^Fp, Gs^Fp, Gs^Fp, Gs^Fp, Gg, Gg, Re, Hh, Xu, Xu, Qxu, Qxu, Uu, Rr, Rr, Qxu, Uu, Xu, Hh, Re, Wo^Xo, Gs^Fp, Wo, Wo, Hh, Gg, Gg, Hh, Hh, Hh, Mm, Gg, Gg, Mm, Mm
Gs^Fp, Gs^Fp, Gs^Fp, Gs^Fp, Gs^Fp, Gs^Fp, Gs^Fp, Gs^Fp, Gs^Fp, Re, Re, Gs^Fp, Gg, Re, Gs^Fp, Gs^Fp, Gs^Fp, Gg, Gs^Fp, Gs^Fp, Gs^Fp, Gs^Fp, Gs^Fp, Gs^Fp, Gs^Fp, Gs^Fp, Gs, Gs^Fp, Gs^Fp, Gs^Fp, Wo, Wo, Wo^Xo, Wo^Xo, Hh, Wo^Xo, Gs^Fp, Hh, Gs^Fp, Gs^Fp, Gg, Gs^Fp, Re, Gs^Fp, Gs^Fp, Gs^Fp, Gs^Fp, Gs^Fp, Gs^Fp, Gs^_s, Gs^_s, Gs^_s, Gs^Fp, Gs^Fp, Gs^Fp, Gs^Fp, Gs^Fp, Gs^Fp, Gs^Fp, Gs^Fp, Gs^Fp, Re, Gs^Fp, Gs^Fp, Gs^Fp, Gs^Fp, Gs^Fp, Gs^Fp, Gs^Fp, Gs^Fp, Gs^Fp, Gg, Gg, Re, Hh, Xu, Xu, Xu, Xu, Qxu, Qxu, Qxu, Rr, Rr, Xu, Xu, Re, Wo^Xo, Wo^Xo, Gg, Wo, Hh, Hh, Hh, Hh, Gg, Gg, Gg, Mm, Mm, Mm, Mm
Gs^Fp, Gs^Fp, Gs^Fp, Gs^Fp, Gs^Fp, Gs^Fp, Gs^Fp, Gs^Fp, Gs^Fp, Re, Gs^Fp, Re, Re, Re, Re, Gg, Gg, Gs^Fp, Gs^Fp, Gs^Fp, Gs^Fp, Gs^Fp, Gs^Fp, Gg, Gs^Fp, Gs^Fp, Gs^Fp, Gs^Fp, Gs^Fp, Wo, Wo^Xo, Wo^Xo, Gs^Fp, Hh, Gs^Fp, Hh^Vhh, Hh, Gs^Fp, Gs^Fp, Gs^Fp, Gs^Fp, Gs^Fp, Re, Gs^Fp, Gs^Fp, Gs^Fp, Gs^Fp, Gs^Fp, Gs^Fp, Gs^_s, Gs^_s, Gs^_s, Gs^Fp, Gs^Fp, Gs^Fp, Gg, Gs^Fp, Gs^Fp, Gs^Fp, Gs^Fp, Gs^Fp, Re, Re, Gs^Fp, Gs^Fp, Gs^Fp, Gs^Fp, Gs^Fp, Gs^Fp, Gs^Fp, Gs^Fp, Gs^Fp, Gg, Re, Re, Hh, Xu, Xu, Xu, Qxu, Qxu, Uu, Rr, Xu, Xu, Xu, Ww, Re, Ww, Gs^Fp, Ww, Gg, Gg, Gg, Hh, Gg, Hh, Mm, Mm, Mm, Mm, Mm
Gs^Fp, Gs^Fp, Gs^Fp, Gs^Fp, Gs^Fp, Gs^Fp, Gs^Fp, Gs^Fp, Gs^Fp, Gs^Fp, Gs^Fp, Gs^Fp, Gs^Fp, Gs^Fp, Re, Gg, Gs^Fp, Gs^Fp, Gs^Fp, Gs^Fp, Gg, Gs^Fp, Gs^Fp, Gs^Fp, Gs^Fp, Gs^Fp, Gs^Fp, Gs^Fp, Gs, Gs^Fp, Gs^Fp, Gs^Fp, Gs^Fp, Hh, Gs^Fp, Hh, Gs^Fp, Gs^Fp, Gs^Fp, Gs^Fp, Re, Re, Gs^Fp, Gs^Fp, Gs^Fp, Gs^Fp, Gs^Fp, Gs^Fp, Gs^_s, Gs^_s, Gs^_s, Gs^_s, Gs^Fp, Gs^Fp, Gs^Fp, Gs^Fp, Gs^Fp, Gs^Fp, Gs^Fp, Gs^Fp, Gs^Fp, Re, Re, Gs^Fp, Gs^Fp, Gs^Fp, Gs^Fp, Gs^Fp, Gs^Fp, Gs^Fp, Gs^Fp, Gs^Fp, Gg, Gg, Hh, Re, Xu, Xu, Xu, Qxu, Qxu, Qxu, Ww, Ww, Ww, Ww, Xu, Ww, Ww, Gs^Fp, Ww, Ww, Wwf, Hh, Ww, Hh, Ww, Hh, Ww, Mm, Ww, Ww
Gs^Fp, Gs^Fp, Gs^Fp, Gs^Fp, Gs^Fp, Gs^Fp, Gs^Fp, Gs^Fp, Gs^Fp, Gs^Fp, Gs^Fp, Gs^Fp, Gs^Fp, Gs^Fp, Re, Gs^Fp, Gs^Fp, Gs^Fp, Gs, Gs^Fp, Gs^Fp, Gs^Fp, Gs^Fp, Gs^Fp, Gs^Fp, Gs^Fp, Gs, Gs^Fp, Gs^Fp, Gs^Fp, Gs^Fp, Gs^Fp, Gs^Fp, Gs^Fp, Gs^Fp, Gs^Fp, Gs^Fp, Gs^Fp, Gs^Fp, Gg, Re, Gs^Fp, Gs^Fp, Gs^Fp, Gs^Fp, Gs^Fp, Gs^Fp, Gs^Fp, Gs^_s, Gs^_s, Gs^_s, Gs^Fp, Gs^Fp, Gs^Fp, Gs^Fp, Gs^Fp, Gs^Fp, Gs^Fp, Gs^Fp, Gs^Fp, Gs^Fp, Gs^Fp, Re, Gs^Fp, Gs^Fp, Gs^Fp, Gs^Fp, Gs^Fp, Gs^Fp, Gs^Fp, Gs^Fp, Gs^Fp, Gs^Fp, Gg, Gs^Fp, Hh, Re, Xu, Xu, Qxu, Qxu, Qxu, Rr, Rr, Xu, Xu, Xu, Ww, Gg, Ww, Gg, Gs^Fp, Gg, Wwf, Hh, Ww, Hh, Ww, Mm, Ww, Mm, Mm
Gs^Fp, Gs^Fp, Gs^Fp, Gs^Fp, Gs^Fp, Gs^Fp, Gs^Fp, Gs^Fp, Gs^Fp, Gs^Fp, Gs^Fp, Gs^Fp, Gs^Fp, Gs^Fp, Re, Gs^Fp, Gs^Fp, Gs^Fp, Gs^Fp, Gs^Fp, Gs^Fp, Gs^Fp, Gs^Fp, Gs^Fp, Gg^Ve, Gs^Fp, Gs^Fp, Gs^Fp, Gs^Fp, Gs^Fp, Gs^Fp, Gg, Gs^Fp, Gs^Fp, Gs^Fp, Gs^Fp, Gg, Gs^Fp, Re, Re, Gs^Fp, Gs^Fp, Gs^Fp, Gs^Fp, Gs^Fp, Gs^Fp, Gs^Fp, Gs^Fp, Gs^_s, Gs^_s, Gs^_s, Gs^Fp, Gs^Fp, Gs^Fp, Gs^Fp, Gs^Fp, Gg, Gs^Fp, Gs^Fp, Gs^Fp, Gs^Fp, Gs^Fp, Gg, Re, Gs^Fp, Gs^Fp, Gs^Fp, Gs^Fp, Gs^Fp, Gs^Fp, Gs^Fp, Gs^Fp, Gs^Fp, Gg, Gs^Fp, Gg, Re, Xu, Xu, Xu, Qxu, Qxu, Rr, Rr, Rr, Re, Ww, Ww, Ww, Gs^Fp, Gg, Gg, Gg, Hh, Gg, Hh, Hh, Hh, Gs^Fp, Mm, Mm, Mm
Gs^Fp, Gs^Fp, Gs^Fp, Gs^Fp, Gs^Fp, Gs^Fp, Gs^Fp, Gs^Fp, Gs^Fp, Gs^Fp, Gs^Fp, Gs^Fp, Gs^Fp, Gs^Fp, Re, Gs^Fp, Gs^Fp, Gs^Fp, Gs^Fp, Gs^Fp, Gs^Fp, Gs^Fp, Gs^Fp, Gs^Fp, Gs^Fp, Gs^Fp, Gs^Fp, Gs^Fp, Gs^Fp, Gs^Fp, Gs^Fp, Gs^Fp, Gs^Fp, Gs^Fp, Gs^Fp, Gs^Fp, Re, Gs^Fp, Re, Gs^Fp, Gg, Gg, Gs^Fp, Gs^Fp, Gs^Fp, Gs^Fp, Gs^Fp, Gs^Fp, Gs^_s, Gs^_s, Gs^_s, Gs^Fp, Gs^Fp, Gs^Fp, Gs^Fp, Gs^Fp, Gs^Fp, Gs^Fp, Gs^Fp, Gg, Gs^Fp, Gs^Fp, Gs^Fp, Re, Gs^Fp, Gs^Fp, Gs^Fp, Gs^Fp, Gs^Fp, Gs^Fp, Gs^Fp, Gg, Gs^Fp, Gg, Gg, Gs^Fp, Gs^Fp, Re, Re, Re, Qxu, Qxu, Qxu, Rr, Rr, Ww, Re, Ww, Ww, Ww, Hh, Hh, Hh, Gg, Hh, Gs^Fp, Hh, Gs^Fp, Mm, Mm, Mm, Mm
Gs^Fp, Gs^Fp, Gg^Ve, Gs^Fp, Gs^Fp, Gs^Fp, Gs^Fp, Gs^Fp, Gs^Fp, Gs^Fp, Gs^Fp, Gs^Fp, Re, Re, Gs^Fp, Gs^Fp, Gs^Fp, Gs^Fp, Gs^Fp, Gs^Fp, Gs^Fp, Gs^Fp, Gs^Fp, Gs^Fp, Gs^Fp, Gs^Fp, Gs^Fp, Gg, Gs^Fp, Gs^Fp, Gs^Fp, Gs^Fp, Gs^Fp, Gs^Fp, Re, Re, Gs^Fp, Re, Gs^Fp, Gs^Fp, Gs^Fp, Gs^Fp, Gs^Fp, Gs^Fp, Gs^Fp, Gs^Fp, Gs^Fp, Gs^_s, Gs^_s, Gg^_s, Gs^Fp, Gs^Fp, Gs^Fp, Gs^Fp, Hh, Gs^Fp, Hh, Gg, Gs^Fp, Gg, Gg, Gs^Fp, Re, Re, Gs^Fp, Gs^Fp, Gs^Fp, Gs^Fp, Gs^Fp, Gs^Fp, Gs^Fp, Gg, Gg, Gg, Gs^Fp, Gg, Gg, Hh, Re, Re, Qxu, Qxu, Qxu, Xu, Xu, Xu, Re, Re, Hh, Ww, Gs^Fp, Gs^Fp, Hh, Gg, Gg, Gg, Mm, Mm, Gg, Mm, Mm, Mm
Gs^Fp, Gs^Fp, Gs^Fp, Gs^Fp, Gs^Fp, Gs^Fp, Gs^Fp, Gs^Fp, Gs^Fp, Gs^Fp, Gs^Fp, Gs^Fp, Gs^Fp, Re, Re, Gs^Fp, Gs^Fp, Gs^Fp, Gs^Fp, Gs^Fp, Gs^Fp, Gs^Fp, Gs^Fp, Gs^Fp, Gs^Fp, Gs^Fp, Gs^Fp, Gs^Fp, Gs^Fp, Gs^Fp, Gs^Fp, Gs^Fp, Gs^Fp, Gg, Re, Re, Gs^Fp, Gs^Fp, Gs^Fp, Gs^Fp, Gs^Fp, Gs^Fp, Gs^Fp, Gs^Fp, Gs^Fp, Gs^Fp, Gs^_s, Gs^_s, Gs^_s, Gs^_s, Gs^Fp, Gs^Fp, Gs^Fp, Hh, Hh, Hh, Gg, Hh, Hh, Gs^Fp, Gs^Fp, Gg, Re, Gs^Fp, Gg, Gs^Fp, Gs^Fp, Gs^Fp, Gs^Fp, Gs^Fp, Gs^Fp, Gs^Fp, Gg, Gs^Fp, Gs^Fp, Gs^Fp, Gg, Hh, Hh, Re, Re, Qxu, Qxu, Xu, Hh, Mm, Mm, Hh, Hh, Ww, Gs^Fp, Gs^Fp, Gg, Hh, Hh^Vhh, Mm, Mm, Mm, Mm, Mm, Mm, Mm
Gs^Fp, Gs^Fp, Gs^Fp, Gs^Fp, Gs^Fp, Gs^Fp, Gs^Fp, Gs^Fp, Gs^Fp, Gs^Fp, Gs^Fp, Gs^Fp, Gs^Fp, Gs^Fp, Gs^Fp, Re, Re, Gs^Fp, Re, Gs^Fp, Gs^Fp, Gs, Gs^Fp, Gs^Fp, Gs^Fp, Gs^Fp, Gs^Fp, Gs^Fp, Gs^Fp, Gs^Fp, Gs^Fp, Gs^Fp, Re, Re, Gs^Fp, Gs^Fp, Gs^Fp, Gs^Fp, Gs^Fp, Gs^Fp, Gs^Fp, Gs^Fp, Gs^Fp, Gs^Fp, Gs^Fp, Gs^Fp, Gs^_s, Gs^_s, Gs^_s, Gg^_s, Gs^Fp, Gs^Fp, Gs^Fp, Gs^Fp, Gs^Fp, Gs^Fp, Gs^Fp, Gg, Gs^Fp, Gg, Gg, Gg, Re, Gs^Fp, Gg, Gg, Gs^Fp, Gs^Fp, Gs^Fp, Gs^Fp, Gs^Fp, Gs^Fp, Gs^Fp, Gs^Fp, Gs^Fp, Gs^Fp, Gg, Hh, Hh, Re, Re, Qxu, Qxu, Hh, Hh, Mm, Gs^Fp, Mm, Hh, Ww, Ww, Gg, Mm, Mm, Mm, Mm, Mm, Mm, Mm, Mm, Mm, Mm
Gs^Fp, Gs^Fp, Gs^Fp, Gs^Fp, Gs^Fp, Gs^Fp, Gs^Fp, Gs^Fp, Gs^Fp, Gs^Fp, Gs^Fp, Gs^Fp, Gs^Fp, Gs^Fp, Gs^Fp, Gs^Fp, Gs^Fp, Re, Re, Re, Re, Gg^Ve, Gs^Fp, Gs^Fp, Re, Gs^Fp, Gs^Fp, Gs^Fp, Gs^Fp, Gs^Fp, Gs^Fp, Gs^Fp, Re, Gs^Fp, Gs^Fp, Gs^Fp, Gs^Fp, Gg, Gg, Gs^Fp, Gs^Fp, Gs^Fp, Gs^Fp, Gs^Fp, Gs^Fp, Gs^_s, Gs^_s, Gs^_s, Gs^_s, Gs^Fp, Gs^Fp, Gg, Gs^Fp, Gg, Gg, Gs^Fp, Gg, Gg, Gg, Gg, Gs^Fp, Gg, Re, Gs^Fp, Gg, Gs^Fp, Gs^Fp, Gs^Fp, Gs^Fp, Gs^Fp, Gs^Fp, Gs^Fp, Gg, Gg, Gg, Gs^Fp, Gg, Gg, Hh, Hh, Re, Qxu, Qxu, Hh, Hh, Mm, Mm, Mm, Mm, Mm, Mm, Ww, Ww, Mm, Mm, Mm, Mm, Mm, Mm, Mm, Mm, Mm
Gs^Fp, Gs^Fp, Gs^Fp, Gs^Fp, Gs^Fp, Gs^Fp, Gs^Fp, Gs^Fp, Gs^Fp, Gs^Fp, Gs^Fp, Gs^Fp, Gs^Fp, Gs^Fp, Gs^Fp, Gs^Fp, Gs^Fp, Gs^Fp, Gs^Fp, Gs^Fp, Ss, Re, Re, Re, Gs^Fp, Re, Re, Re, Re, Re, Re, Re, Re, Gs^Fp, Gg, Gs^Fp, Gs^Fp, Gs^Fp, Gs^Fp, Gs^Fp, Gg, Gs^Fp, Gs^Fp, Gs^Fp, Gs^_s, Gs^_s, Gs^_s, Gs^_s, Gs^_s, Gs^Fp, Gs^Fp, Gs^Fp, Gg, Gs^Fp, Gg, Gg, Gs^Fp, Gg, Gs^Fp, Gg, Gg, Gg, Gg, Re, Gs^Fp, Gg, Gs^Fp, Gg, Gs^Fp, Gs^Fp, Gs^Fp, Gs^Fp, Gs^Fp, Gg, Gs^Fp, Gg, Gs^Fp, Hh, Hh, Re, Re, Qxu, Qxu, Qxu, Qxu, Hh, Mm, Mm, Mm, Mm, Mm, Mm, Ww, Mm, Mm, Mm, Mm, Mm, Mm, Mm, Mm, Mm
Gs^Fp, Gs^Fp, Hh, Gs^Fp, Gs^Fp, Gs^Fp, Gs^Fp, Gs^Fp, Gs^Fp, Gs^Fp, Gs^Fp, Gs^Fp, Gs^Fp, Gs^Fp, Gs^Fp, Gs^Fp, Gs^Fp, Gs^Fp, Gs^Fp, Gs^Fp, Re, Ss, Ss, Gs^Fp, Gs^Fp, Gs^Fp, Gs^Fp, Gs^Fp, Gs^Fp, Gs^Fp, Gs^Fp, Re, Gs^Fp, Gg, Gs^Fp, Gs^Fp, Gs^Fp, Gs^Fp, Gs^Fp, Gs^Fp, Gs^Fp, Gs^Fp, Gg, Gs^Fp, Gs^_s, Gs^_s, Gs^_s, Gs^_s, Gs^_s, Gs^Fp, Gs^Fp, Gg, Gs^Fp, Gs^Fp, Gs^Fp, Gs^Fp, Gs^Fp, Gs^Fp, Gg, Gs^Fp, 1 Gg, Gs^Fp, Re, Re, Gs^Fp, Gg, Gs^Fp, Gs^Fp, Gs^Fp, Gs^Fp, Gs^Fp, Gs^Fp, Gs^Fp, Gs^Fp, Gs^Fp, Gg, Gg, Hh, Hh, Hh, Hh, Mm, Mm, Qxu, Qxu, Qxu, Qxu, Mm, Mm, Mm, Mm, Mm, Mm, Ww, Ww, Mm, Mm, Mm, Mm, Mm, Mm, Mm
Gs^Fp, Gs^Fp, Gs^Fp, Hh, Gs^Fp, Gs^Fp, Gs^Fp, Gs^Fp, Gs^Fp, Gs^Fp, Gs^Fp, Gs^Fp, Gs^Fp, Gs^Fp, Gs^Fp, Gs^Fp, Gs^Fp, Gs^Fp, Gs^Fp, Gs^Fp, Gs^Fp, Ss, Gs^Fp, Gs^Fp, Gs^Fp, Gs^Fp, Gs^Fp, Gs^Fp, Gs^Fp, Gs^Fp, Gs^Fp, Gs^Fp, Gs^Fp, Gs^Fp, Gs^Fp, Gs^Fp, Gs^Fp, Gs^Fp, Gs^Fp, Gs^Fp, Gs^Fp, Gs^Fp, Gs^Fp, Gs^_s, Gg^_s, Gs^_s, Gs^_s, Gs^_s, Gs^_s, Gs^Fp, Gs^Fp, Gs^Fp, Gs^Fp, Gs^Fp, Gs^Fp, Gs^Fp, Gg, Gs^Fp, Gg, Gg, Gg, Re, Gg, Gs^Fp, Gg, Gg, Gg, Gs^Fp, Gs^Fp, Gs^Fp, Gs^Fp, Gs^Fp, Gs^Fp, Gg, Gs^Fp, Gg, Gs^Fp, Hh, Hh, Hh, Gg, Gg, Mm, Mm, Mm, Qxu, Qxu, Qxu, Qxu, Mm, Mm, Mm, Mm, Mm, Mm, Ww, Mm, Mm, Mm, Mm, Mm, Mm
Gs^Fp, Gs^Fp, Gs^Fp, Gs^Fp, Gs^Fp, Gs^Fp, Gs^Fp, Gs^Fp, Gs^Fp, Gs^Fp, Gs^Fp, Gs^Fp, Gs^Fp, Gs^Fp, Gs^Fp, Gs^Fp, Gs^Fp, Gs^Fp, Gs^Fp, Gs^Fp, Gs^Fp, Gs^Fp, Gs^Fp, Gs^Fp, Gs^Fp, Gs^Fp, Gs^Fp, Gs^Fp, Gs^Fp, Gs^Fp, Gs^Fp, Gs^Fp, Gs^Fp, Gs^Fp, Gs^Fp, Gs^Fp, Gs^Fp, Gs^Fp, Gs^Fp, Gs^Fp, Gs^Fp, Gg, Gs^Fp, Gs^_s, Gs^_s, Gs^_s, Gs^_s, Gs^_s, Gs^_s, Gs^Fp, Gs^Fp, Gs^Fp, Gs^Fp, Gs^Fp, Gs^Fp, Gs^Fp, Gg, Gg, Gg, Gg, Re, Re, Gg, Gg, Gg, Gg, Gg, Gs^Fp, Gs^Fp, Gs^Fp, Gs^Fp, Gs^Fp, Gs^Fp, Gg, Gs^Fp, Gg, Gs^Fp, Gs^Fp, Gs^Fp, Gs^Fp, Gs^Fp, Gs^Fp, Gs^Fp, Mm, Mm, Mm, Mm, Qxu, Qxu, Mm, Gs^Fp, Mm, Mm, Mm, Mm, Wwf, Wwf, Mm, Mm, Mm, Mm, Mm
Gs^Fp, Gs^Fp, Gs^Fp, Gs^Fp, Gs^Fp, Gs^Fp, Gs^Fp, Gs^Fp, Gs^Fp, Gs^Fp, Gs^Fp, Gs^Fp, Gs^Fp, Gs^Fp, Gs^Fp, Gs^Fp, Gs^Fp, Gs^Fp, Gs^Fp, Gs^Fp, Gs^Fp, Gs^Fp, Gs^Fp, Gs^Fp, Gs^Fp, Gs^Fp, Gs^Fp, Gs^Fp, Gs^Fp, Gs^Fp, Gs^Fp, Gs^Fp, Gs^Fp, Gs^Fp, Gs^Fp, Gs^Fp, Gs^Fp, Gs^Fp, Gs^Fp, Gs^Fp, Gs^Fp, Gg, Gs^Fp, Gs^_s, Gs^_s, Gs^_s, Gs^_s, Gs^_s, Gs^Fp, Gs^Fp, Gs^Fp, Gs^Fp, Gs^Fp, Gs^Fp, Gs^Fp, Gs^Fp, Gg, Gg, Gg, Gg, Re, Re, Gg, Gg, Gg, Gg, Gg, Gs^Fp, Gs^Fp, Gs^Fp, Gs^Fp, Gs^Fp, Gs^Fp, Gg, Gs^Fp, Gg, Gs^Fp, Gs^Fp, Gs^Fp, Gs^Fp, Gs^Fp, Gs^Fp, Gs^Fp, Mm, Mm, Mm, Mm, Qxu, Qxu, Mm, Gs^Fp, Mm, Mm, Mm, Mm, Wwf, Wwf, Mm, Mm, Mm, Mm, Mm
