Gs, Gs, Gs, Gs^Ft, Gs^Ft, Gg, Gs^Ft, Gg, Gs, Wwt, Wwt, Wwt, Wwt, Gll, Rb, Sm, Sm^Edb, Sm, Ss, Gll, Gll^Qhh, Gll, Gll, Gll, Ss, Ss, Ss, Sm, Ss^Ewl, Gll, Ss, Ss, Ss, Gll, Ss^Ewl, Gll
Gs, Gs, Gd^Vct, Gs^Ft, Gs^Ft, Gs^Ft, Ss, Gll, Gs, Wwt, Wwt, Wwt, Wwt, Gll, Rb, Sm, Ss, Ss, Ss^Ewl, Ss, Gll^Qhh, Gll, Gll, Rb, Ss, Ss, Sm, Sm, Ss, Gd^Fts, Gd^Fts, Sm, Sm, Ss^Ewl, Ss^Ewl, Ss
Gg, Gg, Gs, Ss, Ss, Gs^Ft, Ss, Ss, Ss, Gs, Gs, Wwt, Wwt^Vhs, Wwt^Ewl, Rb, Sm^Edb, Sm^Ewl, Sm^Ewl, Rb, Rb, Gll, Re^Vht, Rb, Ss, Ss, Ss, Sm^Edb, Ss, Gd^Fts, Gd^Fts, Gd^Fts, Ss, Ss^Ewl, Sm^Edb, Sm, Sm^Edb
Gg, Gg, Gs, Ss, Cer, Ss, Gll, Gll, Gll, Gll, Gs, Wwt, Gs, Gll, Gd^Fts, Rb, Sm^Edb, Ss, Gll, Gll, Gd^Fts, Gd^Fts, Rb, Sm, Sm, Ss^Ewl, Gll, Gll, Rb, Rb, Rb, Cse, Ss, Sm^Edb, Wog, Sm
Gs, Gs, Re^Vct, Cer, 1 Kerg, Cer^Vct, Gll, Wwt^Vhs, Gs, Gs, Wwt, Wwt, Gs, Gd^Em, Gd^Qhh, Rb, Gll, Gll, Gll, Sm^Edb, Sm, Gll^Feth, Gll, Ss, Ss, Ss, Gll, Gll, Rb, Cte, 2 Kse, Cse, Sm, Sm, Wog, Sm^Edb
Re, Re, Cer, Cer, Re, Re, Wot, Wot, Wwt, Wwt, Gs, Gs, Gd^Em, Gd^Qhh, Hhd^Qhh, Gll, Sm, Sm, Gll, Gll, Ss^Qhu, Ss^Qhu, Sm, Gll, Gll, Ss^Bh/, Gll, Gll, Gll, Rb, Rb, Rb, Sm^Edb, Ss^Ewl, Wwg, Wog
Gs, Re, Re, Re, Gs, Gs, Gd^Fts, Wot, Wwt, Wwt, Gs, Re^Vht, Gll, Gd^Qhh, Gll, Gll, Sm, Ss^Qhu, Gll, Gll, Sm^Edb, Sm^Edb, Sm^Ewl, Sm^Edb, Sm, Ss^Qhu, Gll, Hhd^Qhh, Hhd^Qhh, Re^Vht, Gd^Em, Gll, Rb, Sm, Ss, Ss
Gd^Fts, Gs, Gs, Gd^Vct, Re, Gs^Qhu, Gd^Fts, Wot, Wot, Wwt, Wwt, Gs, Ss^Ewl, Gll, Ss^Qhu, Rb, Ss^Qhu, Sm, Gd, Hhd^Qhh, Gll, Ss^Qhu, Sm^Ewl, Ss^Qhu, Sm, Ss^Qhu, Gll, Gd, Hhd^Qhh, Gd^Em, Gd, Gd, Rb, Sm, Ss^Ewl, Ss
Gd^Fts, Gd^Fts, Gg, Gs, Gd^Vct, Gd^Qhu, Gd^Fts, Gd^Fts, Wot, Wot, Wwt, Ss, Ss^Ewl, Sm, Sm, Sm, Rb, Gs^Ft, Gs^Ft, Hhd^Qhh, Hhd^Qhh, Rb, Ss, Sm, Sm, Ss^Qhu, Gll, Gll, Gd, Hhd^Qhh, Gd^Fts, Gd^Fts, Ss, Wwg, Sm^Edb, Sm^Edb
Gd^Fts, Gd^Fts, Gs, Gs, Re, Gs^Qhu, Gs, Gd^Fts, Wwt, Ww^Ewl, Ss^Ewl, Sm, Sm, Sm^Edb, Gll, Rb, Gll, Gs^Ft, Gd, Gd, Gd, Gll, Rb, Ss^Ewl, Sm^Edb, Sm, Sm, Gll, Gll, Gd, Gd^Fts, Ss, Ss, Wwg, Ss^Ewl, Ss
Gd^Fts, Gs, Gd^Fts, Gd^Fts, Gd^Fts, Re, Ww^Bh\, Wwt, Ww^Ewl, Sm^Edb, Ss^Vhs, Ss^Ewl, Sm, Gs^Ft, Gs^Ft, Gd, Gd, Gd, Gd, Gd, Hhd^Em, Gll, Rb, Ss, Sm, Ss, Gll, Gll, Re^Vht, Gll, Gll, Gd^Fts, Gll, Rb, Gd^Fts, Gll^Fms
Gs, Gs, Gd^Fts, Gd^Fts, Wwt, Ww, Gll, Gll, Gll, Sm^Edb, Sm, Sm, Rb, Gs^Ft, Gll, Gll, Gll, Gd, Gs^Ft, Gd, Ss^Vhs, Hhd^Qhh, Hhd, Rb, Sm^Qhh, Ss^Ewl, Ss, Gll, Ss^Ewl, Ss, Gll, Gll, Gd^Em, Gd^Fts, Gd^Fts, Gd^Fts
Gd^Fts, Gd^Fts, Gd^Fts, Gd^Fts, Wwt, Gll, Hhd, Hhd, Hhd^Vht, Gll, Ss^Ft, Ss^Ft, Gll, Gll, Sm^Edb, Sm, Sm^Ewl, Sm^Edb, Ss, Sm, Gll, Gll, Gd, Ss^Ewl, Ss, Sm^Qhh, Ss, Sm, Ss^Ewl, Sm^Edb, Gd^Fts, Gll, Gll, Gd^Em, Gg, Gg
Gd^Fts, Gd^Fts, Wwt, Wwt, Gll, Gll, Gd, Gll, Rb, Gll, Ss^Ft, Ss^Ewl, Ss^Ewl, Gll, Gll^Qhh, Ss^Ewl, Sm^Ewl, Sm^Ewl, Sm, Ss, Ss^Ewl, Gd^Em, Gd, Gll, Sm, Sm^Qhh, Sm^Qhh, Sm^Qhh, Sm, Sm, Gll, Gll, Ss^Vhs, Gll, Gll, Gg
Wwt, Wwt, Gd^Fts, Gll, Gd, Gd^Em, Gd, Gll, Ss^Ft, Wwg, Wwg, Ss^Ft, Sm, Gll, Gll^Qhh, Ss, Ss, Hhd, Ss, Sm, Sm, Gll, Ss, Gd^Fts, Gd^Fts, Ss, Sm^Edb, Ss^Ewl, Gll, Gll, Ss^Ft, Ss^Ft, Ss, Gll, Gll, Gll
Gd^Fts, Gd^Fts, Gd^Fts, Gd, Gd, Gd^Em, Gd, Rb, Ss^Ft, Sm^Edb, Wwg, Ss^Ft, Gll, Gll, Gll, Ss^Vhs, Gll, Hhd, Gll, Ss^Ewl, Rb^Qhh, Sm^Edb, Ss^Ewl, Gd^Fts, Gd^Em, Gll, Gd^Em, Gll, Gll, Gll, Ss, Ss^Ewl, Ss^Ewl, Sm, Ss^Qhu, Ss^Qhu
Gll, Gd^Fts, Rb, Gd^Fts, Rb, Gd^Em, Gll, Ss^Ft, Ss^Ft, Ss^Ft, Sm, Sm, Gll, Gll, Rb, Gll, Gd^Em, Gd, Gd^Em, Rb^Qhh, Rb^Qhh, Sm^Edb, Ss, Ss^Vhs, Gll, Gd, Gd^Qhh, Gd^Qhh, Cse, Ss, Ss, Sm^Edb, Ss^Qhu, Sm, Sm, Sm^Edb
Ss^Ft, Ss^Ewl, Ss^Ft, Ss^Ft, Sm^Edb, Rb, Gll, Ss^Ewl, Rb, Sm^Edb, Rb, Ss^Ewl, Rb^Edt, Rb, Rb, Gd, Gll, Gd^Em, Gll^Feth, Gll, Gll, Ss^Ewl, Sm, Ss, Ss, Gd^Fts, Gd^Fts, Cse, 3 Kse, Cse, Sm^Edb, Sm, Ss^Qhu, Ss^Qhu, Sm, Sm
Sm^Ewl, Ss^Ft, Ss^Ft, Sm^Edb, Sm, Ss, Gll, Gll^Qhu, Gll^Qhu, Rb, Rb, Rb^Edt, Ss, Ss, Ss, Rb, Ss, Ss^Ewl, Rb, Hhd^Fts, Gll, Ss, Ss, Ss, Sm, Sm, Sm, Sm, Rb^Edt, Rb^Edt, Ss, Sm, Sm, Sm, Sm, Sm
Sm^Edb, Sm^Ewl, Sm^Edb, Ss^Ft, Sm, Ss, Rb, Hhd^Qhh, Hhd^Em, Gll^Qhu, Rb, Ss, Rb^Edt, Rb^Edt, Rb^Edt, Sm^Edb, Sm^Ewl, Ss, Ss, Hhd^Qhh, Gll, Gll, Wwt, Wwt, Sm, Ss, Sm^Edb, Sm, Rb^Edt, Gll^Edt, Gll, Ss, Sm, Ss^Qhu, Sm, Sm
Ss^Ewl, Ss^Ewl, Ss^Ewl, Sm^Ewl, Sm^Ewl, Sm^Ewl, Rb, Hhd^Fts, Hhd^Qhh, Re^Vhs, Gll, Rb, Gll, Gll, Ss, Ss^Ewl, Sm^Ewl, Ss, Sm, Sm^Edb, Ss, Ww^Ewl, Wwt, Ss^Ewl, Sm, Sm^Ewl, Ss^Qhu, Rb, Gd^Fts, Gll, Gll, Rb, Rb, Rb, Ss, Ss
Gll, Ss, Hhd, Hhd, Hhd, Ss^Ewl, Gd^Fts, Gd^Fts, Gll, Gll, Gll, Gll, Gd^Fts, Gd^Fts, Ss, Sm^Edb, Ss, Ss, Sm, Ss, Wwt, Wwt, Wwt, Ss, Sm, Sm^Ewl, Sm^Ewl, Ss^Qhu, Gd^Fts, Gll^Feth, Gd^Fts, Gll^Qhu, Gll^Qhu, Gd^Vht, Gd^Qhu, Gll^Qhu
Gll, Gll, Gll, Hhd, Gll, Gll, Ss^Ft, Rb, Sm^Edb, Ss^Ewl, Sm, Gll, Gd, Gd^Fts, Wwt, Ww, Wwt, Ww, Ww, Ss, Wwt, Ww^Ewf, Gll, Rb, Sm, Ss^Vhs, Gd^Fts, Sm, Sm^Edb, Gd^Fts, Rb, Gll, Gll^Qhu, Gll^Qhu, Gll^Qhu, Gll^Qhu
Ss^Ft, Ss^Ft, Ss^Ewl, Rb, Ss^Ewl, Ss^Ft, Sm^Edb, Sm^Edb, Ss, Sm^Edb, Rb, Gd^Fts, Wwt, Wwt^Bh\, Gll, Wwt^Vht, Gll^Qhh, Wwt, Ww^Ewf, Wwt, Gll, Gd, Hhd, Gll^Feth, Gd^Fts, Sm, Wwg, Sm, Rb, Rb, Gd^Fts, Gll^Fmw, Gll, Gll^Qhu, Gll^Qhu, Gll^Qhu
Ss^Ft, Ss^Ft, Ss^Ft, Ss^Ft, Ss^Ft, Ss^Ft, Sm, Ss, Ss, Ss, Wwt, Ww^Ewf, Gd^Em, Gd, Gd, Gll, Ss, Ss, Ss, Ss, Gd^Fts, Gd^Fts, Hhd, Gd^Fts, Rb, Sm^Edb, Sm^Edb, Sm, Rb, Gll, Gll^Qhu, Gd^Fts, Gll, Ss, Ss, Gll^Qhu
Sm, Sm, Sm, Ss, Sm, Ss, Sm^Edb, Ss, Rb, Ss, Gd, Gd, Gd^Em, Gd^Em, Gll, Gd^Fts, Gd^Fts, Ss^Ewl, Ss, Ss^Ewl, Gll, Gd^Fts, Gd^Em, Gll, Gd^Em, Ss^Ft, Gd, Gll, Gll, Re^Vht, Gll^Qhu, Gll, Ss, Ss^Ewl, Ss, Ss
Ss, Ss^Ewl, Ss, Ss, Sm^Ewl, Sm^Edb, Sm^Edb, Sm, Rb, Gll^Qhu, Gd^Em, Gd, Hhd^Qhh, Hhd^Qhh, Gll, Gd^Fts, Gll, Gll, Gll^Qhu, Gll, Re^Vht, Gd^Em, Gd^Em, Gd^Em, Gd, Gd, Hhd^Em, Gd^Em, Gll, Gll^Qhu, Gll, Gll, Sm^Ewl, Sm^Ewl, Wwg, Wog
Gll^Qhu, Gll, Gll, Ss^Ewl, Ss^Ewl, Ss^Ewl, Rb^Edt, Rb, Gll^Qhu, Gll^Qhu, Gll, Hhd^Qhh, Sm^Edb, Ss, Ss^Ewl, Gll, Ss^Ewl, Gll, Gll^Qhu, Gll^Qhu, Hhd^Em, Hhd^Em, Hhd, Gd^Em, Rb, Rb, Rb, Gll, Rb, Cse, Rb, Gd^Fts, Gd^Fts, Ss^Ewl, Sm, Wog
Gll^Qhu, Gll^Qhu, Gll, Gll, Gll, Rb^Edt, Rb^Edt, Cse, Rb, Gll^Qhu, Gll, Ss^Ewl, Ss^Ewl, Sm^Ewl, Sm, Sm, Ss^Ewl, Gll, Gll^Qhu, Gll, Gd, Gd, Sm, Sm^Edb, Ss, Sm, Ss, Rb^Edt, Cte, 5 Kse, Cte, Gd^Fts, Gd^Fts, Ss, Ss, Ss^Ewl
Rb, Gll^Qhu, Rb, Gll, Rb, Rb^Edt, Cse, 4 Kse, Cte, Rb, Gll, Sm, Sm^Ewl, Sm^Ewl, Wwg^Ewl, Sm, Ss^Ewl, Ss, Gll, Gd^Em, Gd^Em, Gll, Ss^Ewl, Sm^Edb, Sm, Sm^Ewl, Sm^Ewl, Ss, Cse, Cse, Rb^Edt, Rb, Gd^Fts, Rb, Rb, Gll^Fdw
Ss^Ft, Ss, Ss, Ss, Sm, Sm, Sm, Rb^Edt, Rb^Edt, Rb, Gll, Rb, Ss, Ss, Sm, Wog, Wwg, Rb, Gll, Gll, Gll, Gll, Gll, Ss^Ewl, Sm^Edb, Ss^Ft, Sm^Ewl, Ss^Ewl, Rb, Rb^Edt, Rb^Edt, Rb, Rb, Gll, Gg, Gll^Fdw
Ss^Ft, Ss^Ft, Ss^Ft, Sm^Ewl, Sm^Ewl, Ss^Ewl, Ss, Gll, Gll, Re^Vht, Gll, Gll, Gll, Rb, Rb, Ss, Sm^Edb, Rb, Ss^Ewl, Ss^Vhs, Ss^Ewl, Gll, Rb, Rb, Gll, Ss^Ewl, Rb, Gll, Gll, Re^Vht, Gll, Rb, Ss^Ewl, Gll, Gg, Gll^Fdw
Ss, Ss, Sm, Sm, Sm^Ewl, Sm^Ewl, Rb, Gll, Gll, Gll, Gd^Em, Gll^Feth, Gd^Fts, Gd^Fts, Gd^Fts, Rb, Ss, Sm, Sm^Edb, Ss^Ewl, Sm^Edb, Ss^Ewl, Sm, Rb, Gll, Gll, Gd^Fts, Gll, Rb, Gll, Gll, Ss, Sm, Sm, Rb, Gll
Ss^Ewl, Ss, Ss, Ss, Ss^Ewl, Ss, Rb, Gll, Gd^Em, Gd, Gd, Gd^Em, Gd^Fts, Gd^Fts, Gd^Fts, Ss, Sm, Sm, Ss^Ft, Sm^Edb, Ss^Ft, Sm^Edb, Sm, Ss, Gd^Fts, Gd^Fts, Gd^Fts, Gd^Fts, Ss^Ewl, Ss^Ewl, Sm, Gs^Ft, Sm, Ss^Ewl, Ss^Ewl, Rb
Gll, Rb, Gll, Rb, Gll, Rb, Gll, Gll, Gd^Em, Gd, Gd, Gd^Em, Gd^Em, Gd^Fts, Gll, Ss^Ewl, Wog^Ewl, Ss^Ft, Ss^Ft, Ss^Ft, Ss^Ft, Ss^Ft, Ss^Ft, Ss^Ewl, Ss^Ewl, Gd^Fts, Gg, Gd^Fts, Ss^Ewl, Ss, Gs^Ft, Gs^Ft, Gs^Ft, Ss, Ss, Gll
