Wo, Wo, Wo, Wo, Wo, Wo, Wo, Wo, Wo, Wo, Wo, Wo, Wo, Wo, Wo, Wo, Wo, Wo, Wo, Wo, Wo, Ww, Ds, Gg, Gg, Gg, Gg, Gs^Fp, Gs^Fp, Gs^Fp, Gs^Fp, Gs^Fp, Gs^Fp, Gs^Fp
Wo, Wo, Wo, Wo, Wo, Wo, Wo, Wo, Wo, Wo, Wo, Wo, Wo, Wo, Wo, Wo, Wo, Wo, Wo, Wo, Wo, Ww, Ds, Gg, Gg, Gg, Gg, Gs^Fp, Gs^Fp, Gs^Fp, Gs^Fp, Gs^Fp, Gs^Fp, Gs^Fp
Wo, Wo, Wo, Wo, Wo, Wo, Wo, Wo, Wo, Wo, Wo, Wo, Wo, Wo, Wo, Wo, Wo, Wo, Wo, Wo, Wo, Ww, Ds, Gg, Gg, Gg, Gg, Gs^Fp, Gg, Gs^Fp, Gs^Fp, Gs^Fp, Re, Re
Wo, Wo, Wo, Wo, Wo, Wo, Wo, Wo, Wo, Wo, Wo, Wo, Wo, Wo, Wo, Wo, Wo, Wo, Wo, Wo, Wo, Ww, Ds, Gg, Gg, Gg^Vh, Gs^Fp, Gg, Gg, Gs^Fp, Gs^Fp, Re, Gs^Fp, Gs^Fp
Wo, Wo, Wo, Wo, Wo, Wo, Wo, Wo, Wo, Wo, Wo, Wo, Wo, Wo, Wo, Wo, Wo, Wo, Wo, Wo, Wo, Ww, Ds, Gg, Gg, Gg, Gg, Gg, Ce, Ce, Re, Re, Gs^Fp, Gs^Fp
Wo, Wo, Wo, Wo, Wo, Wo, Wo, Wo, Wo, Wo, Wo, Wo, Wo, Wo, Wo, Wo, Wo, Wo, Wo, Wo, Wo, Ww, Ww, Ds, Gg, Gs^Fp, Gg, Gg, Ce, Ce, 2 Ke, Re, Gs^Fp, Gs^Fp
Wo, Wo, Wo, Wo, Wo, Wo, Wo, Wo, Wo, Wo, Wo, Wo, Wo, Wo, Wo, Wo, Wo, Wo, Wo, Wo, Wo, Ww, Ww, Ds, Ds, Gg, Gg, Gg, Gg, Ce, Ce, Re, Gs^Fp, Gs^Fp
Wo, Wo, Wo, Wo, Wo, Wo, Wo, Wo, Wo, Wo, Wo, Wo, Ww^Vm, Wo, Wo, Wo, Wo, Wo, Wo, Wo, Wo, Wo, Ww, Ds, Ds, Gg, Gg, Gg, Gg, Ce, Gg, Ce, Gs^Fp, Gs^Fp
Wo, Wo, Wo, Wo, Wo, Wo, Wo, Wo, Wo, Wo, Wo, Wo, Wo, Wo, Wo, Wo, Wo, Wo, Wo, Wo, Wo, Wo, Wo, Ww, Ds, Gg, Gg, Gg, Gs^Fp, Gg, Gs^Fp, Gs^Fp, Gs^Fp, Gs^Fp
Wo, Wo, Wo, Wo, Wo, Wo, Wo, Wo, Wo, Wo, Wo, Wo, Wo, Wo, Wo, Wo, Wo, Wo, Wo, Wo, Wo, Wo, Wo, Ww, Ww, Ds, Gs^Fp, Gg, Gs^Fp, Gg, Gg, Gs^Fp, Gs^Fp, Gs^Fp
Wo, Wo, Wo, Wo, Wo, Wo, Wo, Wo, Wo, Wo, Wo, Wo, Wo, Wo, Wo, Wo, Wo, Wo, Wo, Wo, Wo, Wo, Wo, Ww, Ww^Bw/, Ds, Ds, Gs^Fp, Gg, Gs^Fp, Gg^Vh, Gs^Fp, Gg, Gg
Wo, Wo, Wo, Wo, Wo, Ww^Vm, Wo, Wo, Wo, Wo, Wo, Wo, Wo, Wo, Wo, Wo, Wo, Wo, Wo, Wo, Wo, Wo, Wo, Wo^Bw|, Ww, Ds, Ds, Gg, Gg, Gg, Gg, Gg, Gs^Fp, Gs^Fp
Wo, Wo, Wo, Wo, Wo, Wo, Wo, Wo, Wo, Wo, Wo, Wo, Wo, Wo, Ww, Wo, Ww, Wo, Wo, Wo, Wo, Wo, Wo, Wo, Ww^Bw/, Ww^Bw/, Ds, Gs^Fp, Gg, Gg, Gs^Fp, Gs^Fp, Gs^Fp, Gs^Fp
Wo, Wo, Wo, Wo, Wo, Wo, Wo, Wo, Wo, Wo, Wo, Wo, Ww, Ww, Ww, Ww, Gg^Vc, Wo, Wo, Wo, Wo, Wo, Wo, Wo, Ww, Ww, Ww^Bw/, Gg, Gg, Gs^Fp, Gg, Gg, Gs^Fp, Gg
Wo, Wo, Wo, Wo, Wo, Wo, Wo, Wo, Wo, Wo, Wo, Wo, Ww, Ww, Gg^Vc, Gg, Gg, Ww, Ww, Wo, Wo^Bw/, Wo^Bw/, Wo, Ww, Wo^Bw/, Re, Ww^Bw\, Ds, Gs^Fp, Gg, Gs^Fp, Gs^Fp, Gs^Fp, Gg
Wo, Wo, Wo, Wo, Wo, Wo, Wo, Wo, Wo, Wo, Wo, Wo, Ww, Ww^Bw\, Gs, Gg, Cme, Ww, Ds, Wo^Bw/, Wo, Wo, Wo^Bw/, Ww^Bw/, Wo, Ww, Ww, Ww^Bw/, Ds, Gg, Gs^Fp, Gg, Gs^Fp, Gg
Wo, Wo, Wo, Wo, Wo, Wo, Wo, Wo, Wo, Wo, Wo, Wo, Ww, Gg, Gg, Gg, Cer, Ds, Gg, Ww, Ww^Bw/, Ww^Bw/, Ww, Ww, Wo^Bw\, Wo, Ww^Bw/, Ds, Ds, Gg, Gg, Gg, Gg, Gg
Wo, Wo, Wo, Wo, Ww^Vm, Wo, Wo, Wo, Wo, Wo, Wo, Ww, Ww, Gg^Vc, Ww, Cme, 3 Ko, Cer, Gg, Ww^Bw/, Ww, Ww, Wo, Ww, Wo, Wo^Bw/, Wo, Ww, Wwf, Gg, Gg^Vh, Gg, Gg, Gg
Wo, Wo, Wo, Wo, Wo, Wo, Wo, Wo, Wo, Wo, Wo, Ww, Ww, Ww, Gg^Wm, Cer, Cer, Cer, Ds, Ds, Wo, Wo, Wo, Wo, Wo, Wo, Wo, Ww, Ww, Wwf, Wwf, Gg, Gg, Gg
Wo, Wo, Wo, Wo, Wo, Wo, Wo, Wo, Wo, Wo, Wo, Wo, Wo, Ww, Ww^Bw/, Gg, Ds, Gg, Ww, Ww, Wo, Wo, Wo, Wo, Wo, Wo, Ww, Ww, Wwf, Wwf, Ww, Wwf, Ww, Ww
Wo, Wo, Wo, Wo, Wo, Wo, Wo, Wo, Wo, Wo, Wo, Wo, Wo, Ww, Ww, Ds, Ww, Ds, Ww, Ww, Wo, Wo, Wo, Wo, Wo, Wo, Ww, Wwf, Ds, Gs, Gs, Ww, Ww, Ww
Wo, Wo, Wo, Wo, Wo, Wo, Wo, Wo, Wo, Wo, Wo, Wo, Wo, Ww, Ww, Ww, Ww, Ww, Ww, Wo, Wo, Wo, Wo, Wo, Wo, Wo, Ww, Wwf, Gs, Gs, Gs, Gs, Gg, Gg
Wo, Wo, Wo, Wo, Wo, Wo, Wo, Wo, Wo, Wo, Wo, Wo, Ww, Ww, Ds, Ds, Ww, Ww, Ww, Wo, Wo, Wo, Wo, Wo, Wo, Wo, Ww, Ds, Gs, Gg^Vh, Gs, Gs, Gg, Gg
Wo, Wo, Wo, Wo, Wo, Wo, Wo, Wo, Wo, Wo, Wo, Wo, Wo, Ww, Ww, Ww, Ww, Ww, Ww, Ww^Vm, Ww, Wo, Wo, Wo, Wo, Wo, Ww, Ds, Gs^Fp, Gs, Gs, Gs, Gs^Fp, Gs^Fp
Wo, Wo, Wo, Ww^Vm, Wo, Wo, Wo, Wo, Wo, Wo, Wo, Wo, Ww, Ww, Ww, Ww, Ww, Ds, Ww, Ww, Ww, Ww, Ww, Wo, Wo, Ww, Ds, Ds, Gs, Gs, Gs^Fp, Gs, Gg, Gg
Wo, Wo, Wo, Wo, Wo, Wo, Wo, Wo, Wo, Wo, Wo, Wo, Wo, Ww, Ww, Ww, Ww, Ww, Ww, Ww, Ww, Ds, Ww^Vm, Ww, Ww, Ww, Ds, Ds, Gs^Fp, Gs, Gs, Gs^Fp, Gs^Fp, Gg
Wo, Wo, Wo, Wo, Wo, Wo, Wo, Wo, Wo, Wo, Wo, Wo, Wo, Ww, Ww, Ww, Ww, Ds, Ww, Ww, Ww, Ds, Ww, Ww, Wwf, Wwf, Ds, Gg, Gs, Gs^Fp, Gs^Fp, Gs^Fp, Gg, Gg
Wo, Wo, Wo, Wo, Wo, Wo, Wo, Wo, Wo, Wo, Wo, Wo, Wo, Wo, Ww, Ww, Ww, Ww, Ww, Ww, Ww, Ww, Ww, Ww, Wwf, Ds, Gg, Gg^Vh, Gg, Gs, Gs^Fp, Gs^Fp, Gs^Fp, Gs^Fp
Wo, Wo, Wo, Wo, Wo, Wo, Wo, Wo, Wo, Wo, Wo, Wo, Wo, Wo, Wo, Wo, Wo, Ww, Ww^Vm, Ww, Ww, Ww, Wwf, Wwf, Ds, Ds, Gs, Gs, Gs, Gs, Gg, Gs^Fp, Gg, Gg
Wo, Wo, Wo, Wo, Wo, Wo, Wo, Wo, Wo, Wo, Wo, Wo, Wo, Wo, Wo, Wo, Ww, Ww, Ww, Ww, Ww, Wwf, Wwf, Wwf, Ds, Ds, Gs, Gs, Gs, Gg, Gs, Gs, Gs^Fp, Gs^Fp
Wo, Wo, Wo, Wo, Wo, Wo, Wo, Wo, Wo, Wo, Wo, Wo, Wo, Wo, Wo, Wo, Wo, Ww, Ds, Ww, Wwf, Wwf, Ds, Ds, Gs, Gs, Gg, Gs, Gg, Gg, Gg^Vh, Gs, Gs^Fp, Gg
Wo, Wo, Wo, Wo, Wo, Wo, Wo, Wo, Ww, Wo, Wo, Wo, Wo, Wo, Wo, Wo, Wo, Ww, Ds, Ds, Ds, Ds, Gs, Ds, Gs, Gg^Vh, Gg, Gs, Gs, Gs, Gs^Fp, Gg, Gs^Fp, Gg
Wo, Wo, Wo, Wo, Wo, Cm, Cm, Cm, Ww, Wo, Ww, Wo, Ww, Wo, Ww, Wo, Ww, Ww, Gs, Ds, Gs, Ds, Gs, Gs, Gg, Gg, Gs, Gs^Fp, Gs^Fp, Gs, Gs^Fp, Gs^Fp, Gs^Fp, Gs^Fp
Ww, Ww, Ww, Wo, Wo, 4 Km, Ww, Ww, Ww, Wo, Ww, Ww^Vm, Ww, Wo, Ww, Ww, Ds, Gs, Gs, Gs, Gs, Gs, Gg, Gg, Re, Gs, Gg, Gs, Gs^Fp, Gs^Fp, Gs^Fp, Gs^Fp, Gs^Fp, Gs^Fp
Ww, Ww, Ww, Wo, Ww, Ww, Ww, Ww, Ww, Wo, Ww, Ww, Ds, Ww, Ds, Ds, Gg, Ds, Gg, Gg, Gg^Ve, Gg, Re, Gg, Gg, Gs, Gg, Gs^Fp, Gs^Fp, Gs^Fp, Gs^Fp, Hh, Hh, Hh
Ds, Ds, Ds, Ww, Ww, Wo, Ww, Ww^Vm, Ww, Ww, Ds, Ww, Ds, Ds, Gg, Ds, Gg, Gg, Gg, Gg, Gg, Re, Gg, Gg, Gg, Gg, Gg, Gs, Gg, Gs^Fp, Hh, Hh, Hh, Hh
Gg, Gg, Gg, Ds, Ww, Ww, Ww, Ww, Ds, Ds, Gg, Ds, Gg, Gg, Gg, Gg, Gg, Re, Re, Re, Gg, Gg, Gg, Gg, Gg, Gg, Gg, Gg, Gs, Gs, Hh, Hh, Hh, Hh
Gg, Gg, Gg, Ds, Ww, Ww, Ww, Ds, Gg, Ds, Gg^Ve, Gg, Gg, Gg, Gg, Re, Gg^Ve, Gg, Gg, Gg, Gg, Gg, Gg, Gg, Gg, Gg, Gg, Gg, Cer, Gs, Hh, Hh, Hh, Hh
Gg, Gg, Gg, Ds, Ww, Gs^Vht, Ww, Ds, Gg, Gg, Re, Gg, Rp, Re, Gg, Gg, Gg, Gg, Gg, Gg, Gg, Gg, Gg, Gg, Gg, Gg^Ve, Gg, Cer, 1 Kerg, Cer, Hh, Hh, Hh, Hh
Gg, Gg, Gg, Ds, Ww, Ww, Ww, Ds, Re, Re, Gg, Re, Gg, Gg, Gg, Gg, Gg, Gg, Gg, Gg, Gg^Ve, Gg, Gg, Gg, Hh, Gg, Hh, Cer, Hh, Rd, Rd, Hh, Hh, Hh
Gg, Gg, Gg, Ds, Wwf, Wwf, Wwf, Ds, Gg, Gg, Gg, Gg, Gg, Gg, Gg, Gg, Gg, Gg, Gg, Gg, Gs, Gs, Gs, Gs, Hh, Hh, Hh, Hh, Hh, Hh, Rd, Hh, Hh, Hh
Gg, Gg, Gg, Ds, Wwf, Wwf, Wwf, Ds, Gg, Gg, Gg, Gg, Gg, Gg, Gg, Gg, Gg, Gg, Gg, Gg, Gs, Gs, Gs, Gs, Hh, Hh, Hh, Hh, Hh, Hh, Rd, Hh, Hh, Hh
