Gs^Fts, Gs^Fts, Gs^Fts, Re, Re, Re, Gg, Ss^Fts, Gs^Fts, Ss, Gs^Fts, Gd^Fts, Gs^Fts, Ss, Gs^Fts, Ss, Gs^Fts, Ss, Gs^Fts, Ss, Ss, Ss, Ss, Ss, Ss, Ss, Ss, Ss, Gll^Ftr, Gll^Ftr, Ss, Gll^Ftr, Gll^Ftr, Gll^Ftr, Re, Md, Hh^Qhh, Md, Md, Ss^Ft, Ss^Ft, Ss^Ft, Ss^Ft, Ss^Ft, Ss^Ft, Ss^Ft, Ss^Ft, Ss, Ss^Ft, Ss, Ss^Ft, Ss
Gs^Fts, Gs^Fts, Gs^Fts, Gg, Sm^Qhu, Re, Re, Gs^Fts, Gg, Gs^Fts, Re, Re, Re, Gs^Fts, Re, Gs^Fts, Gs^Fts, Gs^Fts, Gs^Fts, Gs^Fts, Ss, Ss^Emf, Ss, Ss, Ss^Ft, Ss, Ss, Gll^Ftr, Gll^Ftr, Gll^Ftr, Ss, Gll^Ftr, Gll^Ftr, Gll^Ftr, Re, Md, Hh^Qhh, Md, Md, Ss^Ft, Ss^Ft, Ss^Ft, Ss^Ft, Ss^Ft, Ss, Ss^Ft, Ss, Ss^Ft, Ss, Ss^Ft, Ss, Ss^Ft
Mm, Mm, Mm, Sm^Qhu, Ce^Vct, Sm^Qhu, Gg, Re, Re, Re, Ss^Vhs, Ss, Ss, Re, Ss, Re, Re, Re, Re, Re, Re, Ss^Vhs, Ss, Ss, Ss^Ft, Ss, Ss, Gll^Ftr, Cse, Cse, Kse, Re, Re^Dr, Re, Re, Gll^Ftr, Hh^Vd, Hh^Qhh, Ss^Qhu, Mm, Mm, Ss^Ft, Ss^Ft, Ss, Ss, Ss, Ss, Ss, Ss, Ss, Ss, Ss^Ft
Mm, Md, 2 Ke, Ce, Ce, Sm^Qhu, Sm^Qhu, Gg, Gg, Re, Wwf^Bw\, Ss, Re, Ss, Ss, Ss, Ss, Ss, Ss, Ss, Ss^Bw|, Ss, Ss, Ss, Ss, Ss, Ss, Ss, Ss, Cse, Cse, Re, Hh^Qhh, Gll^Ftr, Gll^Ftr, Re, Ss^Bw\r, Gll^Ftr, Re^Dr, Md, Ss, Md, Hh^Qhh, Ss, Ss, Ss, Ss, Ss, Ss, Ss, Ss, Ss
Hh, Hh, Ce, Ce^Ecf, Sm^Qhu, Ce^Vct, Sm^Qhu, Wwf, Wwf, Wwf, Gg^Efm, Re, Gg, Re, Re, Ss, Gg, Ss, Ss^Ft, Ss, Re^Qhh, Ss, Re^Qhh, Ss, Ss, Ss, Ss, Ss, Ss, Ss, Ss, Ss, Hh^Qhh, Hh^Qhh, Hh^Qhh, Hh^Qhh, Hh^Qhh, Re, Hh^Qhh, Re^Qhh, Ss, Ss, Hh^Qhh, Hh^Qhh, Ss, Ss, Ss, Ss, Ss, Ss, Ss, Ss
Hh, Hh, Ce^Vct, Ce, Ce, Sm^Qhu, Gs^Fts, Gs^Fts, Gg, Gg^Efm, Gg^Fts, Gg^Fts, Gg^Fts, Gg, Gg, Ss^Bw\, Re, Gg, Gg, Ss^Ft, Re^Qhh, Re^Qhh, Ss, Re^Qhh, Ss, Ss, Ss, Ss^Ft, Ss^Ft, Ss, Ss, Ss, Ss, Ss, Ss, Ss, Ss, Hh^Qhh, Ss, Ss, Ss, Ss, Ss, Hh^Qhh, Hh^Qhh, Ss, Ss, Ss, Ss, Ss, Ss, Ss
Gs^Fts, Sm^Qhu, Sm^Qhu, Sm^Qhu, Sm^Qhu, Sm^Qhu, Gg^Vo, Gg, Gg, Gs^Qhhf, Gs^Qhhf, Gs^Qhhf, Gg^Fts, Gg, Ss^Vhs, Ss^Qhu, Gg, Re, Re, Re, Re, Ss^Ft, Ss, Ss, Ss, Ss, Ss^Emf, Ss, Ss, Ss, Ss, Ss, Ss, Ss^Emf, Ss, Ss, Ss, Ss^Emf, Ss^Vhs, Ss, Ss, Ss, Ss, Hh^Qhh, Ss, Ss, Ss, Ss, Ss, Ss, Ss, Ss
Gg^Fts, Gg^Fts, Gs^Fts, Gg^Fts, Gs^Fts, Gg, Gg, Gg, Gg, Gg, Gs^Qhhf, Gs^Qhhf, Gg^Fts, Gs^Emf, Ss^Qhu, Ss^Qhu, Gg, Gs^Fts, Gg, Re, Re, Gs^Qhh, Gs^Qhh, Ss, Gs^Qhh, Gs^Qhh, Gs^Qhh, Ss^Vhs, Re^Qhh, Ss, Re^Qhh, Ss, Ss, Ss^Vhs, Ss, Ss, Ss, Ss, Ss, Ss, Ss, Ss, Ss, Ss, Ss, Ss, Ss^Ft, Ss^Ft, Ss^Ft, Ss, Ss^Ft, Ss
Gg^Fts, Gg^Fts, Gg^Fts, Gg^Fts, Gg^Fts, Gg, Gg^Efm, Gg^Efm, Gg, Gg, Gg, Gs^Qhhf, Gg^Efm, Gg, Gg, Re, Gg, Gg, Re, Re, Gs^Qhh, Re^Qhh, Re^Qhh, Ss, Re^Qhh, Re^Qhh, Ss^Bw\, Ss, Ss^Bw/, Re^Qhh, Re^Qhh, Re^Qhh, Gg, Gs, Gs, Re, Re, Re, Re, Ss, Re, Ss, Re, Ss, Ss, Ss, Ss, Ss^Ft, Ss^Ft, Ss^Ft, Ss^Ft, Ss^Ft
Gg^Fts, Gg^Fts, Gg^Fts, Gg^Fts, Gg, Gg, Gg, Gg, Hh, Ss^Qhu, Ss^Qhu, Gg, Gg^Efm, Gg^Efm, Hhd, Gg, Gs^Fts, Gg^Efm, Gs^Vht, Gs, Gs^Qhh, Gs^Qhh, Gs^Qhh, Re^Qhh, Re^Qhh, Re^Qhh, Ss, Re^Qhh, Ss, Ss, Re^Qhh, Gs^Ft, Gs^Ft, Gs^Ft, Gs^Ft, Gs, Gs, Gs, Gs, Gs, Gs, Gs^Ft, Gs^Ft, Re, Re, Re, Ss, Ss, Ss, Ss^Ft, Ss^Ft, Ss^Ft
Gg^Fts, Gg^Fts, Hh^Fts, Gs^Fts, Hh^Fts, Gg, Gg, Gg, Hh, Hhd, Ss^Qhu, Gg, Gg, Hhd, Hh, Hh^Fts, Gg, Gg, Gg, Gs^Ft, Gg^Qhh, Gs^Qhh, Re^Qhh, Re^Qhh, Ss, Ss, Re^Qhh, Ss, Ss, Re^Qhh, Gg, Gs^Ft, Gg, Gg, Gs, Gs, Hh, Hh^Qhh, Hh^Qhh, Gs, Gs, Gs^Ft, Gs^Ft, Gs^Ft, Gs^Ft, Gs^Ft, Re, Ss, Ss, Ss, Ss, Ss
Hhd^Fts, Hhd^Fts, Hh^Fts, Hh^Fts, Gs^Fts, Gg, Gg^Vo, Gg^Eff, Gg^Eff, Hh, Gg, Gg, Gg, Gg^Vo, Gg, Gg, Gg, Gg, Re, Gg, Gs, Gs, Re^Qhh, Ss^Bw\, Ss^Bw\, Ss, Re^Qhh, Re^Qhh, Ss^Bw\, Re^Qhh, Gs, Hh, Hh, Hh^Qhh, Hh^Qhh, Hh, Hh, Gs, Gs, Gs, Gs^Ft, Gs^Ft, Gs^Ft, Re, Re, Gs^Ft, Ss^Vhs, Ss, Ss, Ss, Ss, Ss
Hhd^Fts, Hh^Fts, Hhd^Fts, Gs^Fts, Sm^Gvs, Sm^Gvs, Sm^Gvs, Sm^Gvs, Gg^Eff, Gg^Eff, Gg^Efm, Gg^Efm, Re, Re, Gg, Gs^Fts, Gg, Re, Wwrt, Ds^Ewsh, Wwt, Gs^Vht, Ww, Ss, Ww^Wkf, Ss^Bw\, Ds^Qhh, Ss, Gg, Re^Qhh, Gg, Gs, Gg, Gs, Gg, Gs^Ft, Gg, Gs^Ft, Gg, Gs^Ft, Ss, Gs^Ft, Ss, Re, Ss, Ss, Ss, Ss, Ss, Ss, Ss, Ss
Hhd^Fts, Hhd^Fts, Gg, Gs^Fts, Gs^Fts, Sm^Gvs, Gg^Eff, Gg^Eff, Re, Re, Re, Re, Wwrt, Re, Gg^Wm, Gs^Fts, Sm^Gvs, Re, Wwt^Wkf, Wwt^Wkf, Wog, Wo, Ww, Wwt, Wwrg^Wkf, Ds, Ds, Gs^Ft, Gg, Gg, Gg, Gs^Ft, Gg, Gg, Gg, Gg, Gg, Gg, Gg, Gs^Ft, Ss, Ss, Ss, Ss, Ss, Ss, Ss, Ss, Ss, Ss, Ss, Re
Gg, Gg, Gg, Gg, Re, Re, Re, Re, Re, Re, Re, Re, Wwrt^Wkf, Wwrt^Wkf, Wwrt, Gs^Vht, Re, Re, Wwt, Wog^Ewl, Wo, Wo, Ww^Wkf, Wwt, Wwt, Ds, Ds, Gs^Ft, Gs^Ft, Gg, Gg, Gs^Ft, Re, Gg^Vht, Gs^Ft, Gg, Re, Gg, Gs^Ft, Gs^Ft, Ss, Ss, Ss, Ss, Ss, Ss, Ss, Ss, Ss, Ss, Ss, Ss
Re, Re, Re, Re, Re, Ds, Hd, Hd^Ewsh, Hd, Ds, Ds, Re, Re, Wwrt^Wkf, Wwrt, Re, Ds, Re, Ds^Ewsh, Wo, Wo, Ww, Wwrg^Wkf, Wwrg^Wkf, Ww, Wwf^Wkf, Wwrg^Wkf, Ds, Gs^Ft, Gg, Gs^Ft, Re, Ss, Gs^Ft, Re, Re, Gs^Ft, Gs^Ft, Gs^Ft, Re, Gs^Ft, Ss, Re, Ss, Ss, Ss, Ss, Ss, Ss, Ss, Ss, Ss
Re, Re, Re, Re, Ds, Ds^Ewsh, Ds, Ds, Ds, Ds^Wm, Wwrt, Ds^Ewsh, Wwt, Re^Esd, Wwt, Wwt^Ewf, Wwt^Wkf, Wwrt^Wkf, Wo, Wo, Ww, Wwg^Wkf, Ww, Wwrg^Es, Wwt, Wwf^Wkf, Ds, Ds, Gg, Gg, Re, Gs^Ft, Ss, Ss, Ss^Bw|, Re, Re, Re, Ss, Gs^Ft, Re, Gs^Ft, 1 Kerg, Cer, Re, Ss, Ss, Ss, Ss, Ss, Ss, Ss
Wwt, Wwt, Wwt, Ds, Wwrt^Wkf, Wwrt^Wkf, Wwt, Wwrt, Ds, Ww^Vhs, Wwt, Wwt, Wo, Wwt^Ewf, Wo, Wo, Wo, Wo^Wkf, Wo, Ww, Wo, Ww, Wog, Ww, Ww^Wkf, Ds, Gg, Gg, Re, Gs^Ft, Ss, Ss, Ss, Ss, Ss^Bw|, Ss, Ss, Ss, Ss, Ss, Ss, Cer, Cer, Cer^Vht, Re, Ss, Ss, Ss, Ss, Ss, Ss, Ss
Wwt, Wwt, Wwt, Wwt^Ewf, Wwt, Wwt, Wwt, Wwt^Ewl, Wwt, Wwt, Wwrg^Wkf, Ww, Wwt, Wo, Wo, Wo, Wo, Wo, Wo, Wog, Wo, Wo, Wo, Ww, Wwrg^Wkf, Ds, Gg, Re, Ss, Ss, Ss, Ss, Ss, Ss, Ss^Bw|, Ss, Ss, Ss, Ss^Vhs, Ss, Ss, Re, Re, Re, Ss, Ss, Ss, Ss, Ss, Ss, Ss, Ss
Wo, Wo, Wot, Wot, Wot, Wo, Wot, Wwt, Ww, Ww, Ds, Ds, Ds, Wwt, Wo, Wo, Wo, Wo, Wo, Wo, Wwrg^Wkf, Ww, Wo, Ww, Ww, Wwrg^Wkf, Rb, Re, Ss, Ss, Re, Re, Re, Ss, Rd, Ss, Ss, Ss, Ss, Ss, Ss, Ss, Ss^Bw|, Ss, Ss^Em, Ss^Em, Ss, Ss^Vhs, Ss, Ss^Em, Ss, Ss
Wo, Wot, Wwt^Ewl, Wwrt, Gd^Ftp, Ds, Ds^Edp, Wwt, Wwrt, Ww, Wwf, Gg^Ft, Gg^Ft, Wwt, Wo, Wo, Wo, Wo, Wo, Ww, Ds, Ds, Ds, Wo, Wo, Wwrg, Rb, Gg^Ft, Re, Re, Co, Gg, Co, Re, Rd^Bw/, Cer, Cer, Ss, Ss, Ss, Ss, Ss, Ss^Bw|, Ss, Ss, Ss, Ss^Em, Ss, Ss, Ss, Ss, Ss
Wo, Wot, Gd^Es, Rd, Rd^Esd, Ds^Edp, Rd, Wwt^Ewf, Gd^Ftp, Wwf, Wwf, Gg^Ft, Wot, Wwt, Wwt, Wo, Wo, Wo, Wo, Ww, Wwf, Gg^Ft, Gg^Ft, Ww^Wkf, Wo, Ww, Ww^Bw/, Gg^Ft, Rb, Gg^Ft, Ko, Ko, Cer^Bw\, Co^Vo, Rd, Re, Rd, Rb^Bw\, Ko, Ss, Rb, Ss, Re, Ss, Ss, Ss, Ss, Ss, Ss, Ss, Ss, Ss
